威风堂堂的作曲是谁	威风堂堂
docker什么时候发行的	docker
哪些人是田馥甄的粉丝	田馥甄
问号的用法有哪些	问号
在中国ppap的名字	ppap
scratch性质是怎样的	scratch
nas网络存储概念有哪些	nas网络存储
广州的邮政区码	广州
.xxx代表什么	.xxx
父亲被谁翻唱过	父亲
欧洲原本代表什么	欧洲
一人我饮酒醉这首曲子有多长	一人
太阳能达到的温度是多少	太阳能
极乐净土罗马音是啥	极乐净土
五证合一的近义词都有什么	合一
熊猫烧香是谁带到这个世界上的	熊猫烧香
文明5用什么平台联机	文明5
中国新歌声的主持人有哪些人	新歌
哪些病毒容易引发塞卡病毒感染	感染
哪年有的全国青少年网络文明公约	青少年
抑郁症都有什么表现	抑郁症
游戏人生的画面如何	游戏人生
ncbi属于的国家	ncbi
摇一摇是谁作的词	摇一摇
放弃我抓紧我的导演么	放弃
雪中悍刀行第一次发行时间	雪中悍刀行
地球的质量是多少	地球
什么学科讲到湿度	湿度
全民超神的下载网址	超神
名侦探柯南剧场版作者名字吧	名侦探柯南剧场版
资本的词义是什么	资本
php的设计人是哪位	php
胡歌的祖籍	胡歌
说几首黄致列有名的歌	说几首黄致列
手术疤痕有哪些办法可以治	手术疤痕
恶魔雪茄的注解	恶魔雪茄
喝拿铁会有哪些不适	拿铁
方大同的歌曲是什么风格	方大同
谷歌学术的用途	谷歌
纸牌屋的imdb编号的介绍	纸牌屋
堂吉诃德的曲作者是谁	堂吉诃德
中山大学有着什么样的人文思想	中山大学
microsoftonenote的发布情况如何	microsoftonenote
择天记发行的第一个网站	择天记
比亚迪股份有限公司有多大面积的地方	比亚迪股份有限公司
呼斯楞的歌曲曲风	呼斯楞
喝拿铁对人有什么坏处	拿铁
163的形式	163
百度的公司叫什么	百度
余罪每集长度	余罪
mindgeek的研发机构	geek
你懂辅酶q10的化学式不	辅酶q10
幽门螺杆菌存在于什么界中	幽门螺杆菌
画江湖之不良人的配乐人	画江湖之不良人
高桥李依什么时候初次亮相的	李依
荀彧有什么经典故事	荀彧
操作系统的组成部分	操作系统
未央宫的建筑面积么	未央宫
谁是九州·天空城的主演	天空城
什么系统可以操作小米手机5	小米手机5
斯里兰卡有着怎样的面积	斯里兰卡
为什么要吃六味地黄丸	六味地黄丸
谁给画江湖之不良人配的乐	画江湖之不良人
谁是张宇的恩师	张宇
京东总部	京东
民族乐派处于的时代	民族乐派
匈牙利的中央银行的名称是	中央银行
上瘾这首歌从哪来的	上瘾
lorde的音乐风格	lorde
bobbytinsley的音乐曲风是啥	bobbytinsley
唐三的那位女婿叫什么名字	唐三
vhd的归属地是哪里	vhd
虎牙在哪个方向	虎牙
往成都打电话的时候需要加什么	成都
双鱼座有什么特征	双鱼座
玄奘都有哪些弟子	玄奘
蓝牙是什么意思	蓝牙
陪你度过漫长岁月唱得是什么语言	陪你度过漫长岁月唱得
谁拍的唐人街探案	唐人街
神奇动物在哪里的作者不	神奇动物
神司马懿有着什么样的技能	神司马懿
啥时候会冬至	冬至
对刘亦菲的爱称有哪些	刘亦菲
京韵大鼓流行地区	京韵大鼓
铁观音是哪个门类的	铁观音
周杰伦专辑是国语还是粤语	周杰伦
机械键盘有哪些优势	机械键盘
中国新歌声的主持人	新歌
深圳地铁11号线的通车时间	深圳地铁11号线
能说出地址位于洛阳的高等院校的名字	出地
fn功能键在哪	fn功能键
龙眼的生物目属么	龙眼
黎明生机的混音师	黎明生机
华山长多少公里	华山
身体乳是用来做什么的	身体乳
中山最具代表性的花	中山
那个无耻之徒都有几季	无耻之徒
seo的诞生时间是什么时候	seo
赵雷的曲风是什么	赵雷
地球的质量	地球
梅毒传播方式	梅毒
玉皇大帝所住的地方叫什么	玉皇大帝
华盛顿哥伦比亚特区的机场	华盛顿哥伦比亚特区
羊肉的味道	羊肉
在哪制造出的长征五号系列运载火箭	长征五号系列运载火箭
希尔瓦娜斯·风行者的姐姐是谁	希尔瓦娜斯·风行者
章鱼哥有哪些朋友	章鱼哥
什么名字代表田馥甄的粉丝	田馥甄
辛普森杀妻案中到底谁是凶手	辛普森杀妻案
神司马懿的技能是啥样的	神司马懿
swot分析法还有哪些说法	swot分析法
画江湖之不良人的作曲是谁	画江湖之不良人
谁是苹果的首席执行官	苹果
美国队长3的制作成本是多少	美国队长3
简单爱的合声编写	简单爱
莫度男爵的老师	男爵
黑洞直径是多少	黑洞
哪个人是w-inds.的主唱	w-inds.
哪里有幻灯片版式	幻灯片
哪家代理发行的魔幻车神	车神
赵冀龙身高体重分别为多少	赵冀龙
圆明园的门票价格	圆明园
英魂之刃用什么画面放的	英魂之刃
股票的内在价值是由什么决定的	内在价值
mac地址的词义	mac地址
阿特拉斯的故事	阿特拉斯
林中鸟是由谁作出的	林中
宋威龙什么比较强	威龙
《皇后大道东》专辑中歌曲总数是多少	皇后大道东
玛丽苏有哪些近义词	玛丽苏
疯狂动物城的imdb编码	动物城
济州岛的首府	济州岛
加利福尼亚州的著名景点是什么	加利福尼亚州
在洛阳的高等院校	高等院校
哪几位是成都的电话区号	位
列举一些郑州的著名人物	郑州
动漫的定义	动漫
哪些演员曾经当过赵敏	赵敏
valve有多少人	valve
麻雀的拍摄地	麻雀
极乐净土用罗马音怎么念	极乐净土
柏拉图的老师是谁	柏拉图
mfc服务的对象一般是谁	mfc
赵雷属于什么流派	赵雷
会计专业在哪个系里	会计专业
iphone7什么程序	iphone7
法医秦明的制片地区	法医
pthread_cond_wait和什么搭配比较合适	pthread_cond_wait
酷儿的身高体重	酷儿
faded的原唱	fad
边境牧羊犬是什么样的动物	边境牧羊犬
电脑配置是什么意思	电脑配置
树莓派的英文缩写是什么	树莓派
可见光的平均速度是多少	可见光
文艺复兴时期的指导思想	文艺复兴
国有企业改革是由什么决定的	国有企业改革
中国旅游的主要景点	中国旅游
李世民的庙号是什么	李世民
中国历史朝代的政治体制是什么	中国历史朝代
巴洛克音乐的流行时间是什么时候	巴洛克音乐
唐僧徒弟有哪些	唐僧
通过什么才能融资	才能
什么时候创办的台湾电影金马奖	台湾电影金马奖
名侦探柯南出了多少集	名侦探
唐纳德·特朗普以什么为行为准则	唐纳德·特朗普
mac地址的意思	mac地址
社会保险核心的价值在哪	社会保险
我不是潘金莲在哪儿拍的	我不是潘金莲
侠盗猎车手5的第一部作品叫什么	侠盗猎车手5
在哪个网站能玩儿全民超神	超神
微软的主要产品有哪些	微软
谁发明的摩尔斯电码	摩尔斯
不为谁而作的歌是哪类音乐	为谁
方大同的演唱风格是什么	方大同
搜狗是哪个公司的	搜狗
抖s的对义词	抖s
平时都应该怎么吃b族维生素	b族维生素
什么日子代表鬼节	鬼节
辛亥革命的推动人物	辛亥革命
鹿晗的国籍	鹿晗
齐鲁制药有限公司用了多少地盘	齐鲁制药有限公司
如果去读麻省理工学院的话会有哪些名人成为校友	麻省理工学院
不知道亚洲还有那种叫法	亚洲
苏小妹爸爸名字	苏小妹
林允是哪个公司旗下的艺人	林允
维生素a的外观	维生素a
pmc是做什么的	pmc
swot分析法别称	swot分析法
尿毒症是怎么回事	尿毒症
谢霆锋的孩子有哪些	谢霆锋
黄瓜怎么做	黄瓜
滨崎里绪亮相于何时	滨崎里绪
pmo有哪些功能	pmo
去海南玩的话有机会见到哪些学校	海南
现在法国总统的名字是	法国总统
什么样的内容主题是生死狙击有的	生死狙击
闪电侠的能力有多强大	闪电侠
什么样性格的是边境牧羊犬具备的	边境牧羊犬
互联网的定义是什么	互联网
李小龙的子女	李小龙
行尸走肉的漫画作者	行尸走肉
互联网为什么叫互联网	互联网
计算月球的离心率为多少	月球
谍影重重是什么分级	谍影重重
自然常数公式	自然常数
他是龙有着怎样的色彩	龙
虎妈猫爸的播出手段	虎妈猫爸
西游记是什么体裁的	西游记
jenkins属于哪类软件	jenkins
二八定律的相近词语还有什么	二八定律
完美世界的出版机构是	完美世界
哪里是bose的公司地址	bose
法医秦明的播出地是	法医
对欢乐颂进行音乐创作的人叫什么	欢乐颂
qq空间的版本是怎样的	qq空间
银魂的出版的时间是多会儿	银魂
路德维希·凡·贝多芬多少岁去世的	路德维希·凡·贝多芬
哪个民族是中国人口的主体民族	主体民族
日本三大妖怪在哪出没	日本三大妖怪
你看不到的天空是谁作词作曲的	你看不到的天空
什么身份是鲁路修·兰佩路基的	鲁路修·兰佩路基
谁教过刘承羽	刘承
hao123附属的公司	hao123
遇到什么样的状况才是runtimeerror	遇到
幽门螺杆菌是什么界的生物	幽门螺杆菌
运作城寨英雄剧本拍摄的人是谁	运作
切·格瓦拉跟谁组成的家庭	切·格瓦拉
latex属于哪个范畴	latex
接触voc容易引发什么疾病	voc
长征五号系列运载火箭的生产国	长征五号系列运载火箭
docker在什么时候发行出来的	docker
五四运动导致了什么	五四运动
杨幂的唱片公司	杨幂
疯巫妖的实验日志是哪的独家首发	疯巫妖的实验日志
flytothesky的歌曲是什么风格	flytothesky
东京食尸鬼的原版叫做	东京食尸鬼
美丽的春天歌手是谁	美丽的春天
迈克尔·乔丹的儿子叫什么名字	迈克尔·乔丹
超少年密码现在的播出状态是怎样的	少年
张宇恩师	张宇
沙溢妻子是哪位	沙溢
hdmi有什么特点么	hdmi
三毛老公叫什么名字	三毛
心理健康状态如何分类	心理健康
深圳地铁11号线的通车时间是什么时候	深圳地铁11号线
acl的规则是什么	acl
ip地址的分类	ip地址
择天记发行的第一个网站是什么网	择天记
林允儿血型是什么	林允儿
acfun的网站口号	acfun
she是谁唱的	she
蓝牙是干什么用的	蓝牙
泰勒·斯威夫特什么时候出道的	泰勒·斯威夫特
济南的特产有哪些	济南
什么疾病能够通过血液透析取得康复	血液透析
莫度男爵是谁的徒弟	男爵
唱lemontree的是谁	lemontree
十二星座象征哪些东西	十二星座
木心当过谁的老师	木心
司马懿多久死的	司马懿
赵丽颖的爱称	赵丽颖
lorde的音乐曲风	lorde
丑八怪是什么专辑里的	丑八怪
辞职信的构成	辞职信
latex属于什么	latex
六法论是什么书的	六法论
刘承羽的老师叫什么	刘承
巴黎人信仰什么宗教	巴黎人
visa的其他翻译方式	visa
张继科的主要奖项	张继科
贞子的恋人	贞子
张艺兴所在的组合叫什么	张艺兴
饕餮原本的意思指啥	饕餮
伊万卡·特朗普的伴侣	伊万卡·特朗普
无翼鸟能飞多快	无翼鸟
你能解释下唾液是啥么	唾液
地球的质量是多少	地球
123是什么	123
马思纯是回族的	马思纯
史蒂夫·乔布斯的生母	史蒂夫·乔布斯
timbaland的唱片公司	timbaland
乔任梁的星座	乔任梁
五位一体在哪里提出的	五位一体
伪装者是由哪部小说改编的	伪装者
金茂大厦高多少米	金茂大厦
梦田的合声	梦田
雪鹰领主里谁才是主角	领主
多少海拔内葡萄能生长	葡萄
周星驰是哪儿的人	周星驰
艾吉奥的后代	艾吉奥
蒙奇.d.路飞是谁配的音	蒙奇
股票的内在价值与什么相关	内在价值
猫是属于什么纲的动物	猫
谁是罗敏庄的夫君	罗敏庄
哪些标签是公主头的	公主头
timbaland加入哪家音乐厂牌	timbaland
哪里是济州岛行政的中心	济州岛
甘雅丹的音乐风格是什么	甘雅丹
西部世界的主演有谁	西部世界
中央电视台在什么地方可以用	中央电视台
法国主要由什么民族组成	法国
锦绣未央卖多少	锦绣未央
拳皇13是怎样表现画面的	拳皇13
雪鹰领主主要在讲谁	领主
如何解释新干线	新干线
二八定律的其他定义	二八定律
中国美不胜收的地方	美不胜收
辞职信的构成有哪些	辞职信
金茂大厦的楼高是多少	金茂大厦
马云的淘宝网成立了多长时间	马云
树莓派的简写是什么	树莓派
电影是从哪个国家发明的	电影
什么词里面有颞	颞
杭州的范围	杭州
马思纯真的是回民人	马思纯
侠盗猎车手5的首作	侠盗猎车手5
1024程序员节该怎么过	1024程序员节
电子商务的要义	电子商务
都有谁管艾吉奥叫先辈	艾吉奥
用拼音怎么输入网页	拼音
贝加尔湖是有多深才能叫贝加尔湖	贝加尔湖
英国首相叫什么	英国首相
极限挑战的播出状态	极限挑战
玛丽苏同义词	玛丽苏
贝拉克·奥巴马老婆资料	贝拉克·奥巴马
蔡依林的唱片购买量是多少	蔡依林
投名状的拍摄成本是怎样的	投名状
心理健康状态的表现有哪些	心理健康
注意什么会减少半月板的发病率	半月板
诗经别称是什么	诗经
巴霍巴利王制作成本到底是多少	巴利
赵冀龙实际身高体重	赵冀龙
谁是游坦之的老师	游坦之
什么才会有阴茎	阴茎
铁凝是什么姓氏的	铁凝
余罪每集多少分钟	余罪
s.t.的中文翻译	s.t.
中东的宗教信仰怎么样	中东
兔子爱吃的	子爱
3d肉蒲团之极乐宝鉴的投资者是哪位	3d肉蒲团之极乐宝鉴
音乐符号的意义在何	音乐符号
银魂什么时候发行的	银魂
苏秦拜于谁门下	苏秦
lorde的歌曲风格	lorde
现任的法国总统是	任
徐志摩前妻	徐志摩
极限挑战现在是什么播出状态	极限挑战
加拿大的国庆节是哪一天	加拿大
绿罗裙的原唱是谁	绿罗裙
景行厅男孩专辑有什么歌曲	景行厅男孩
发明3d打印的人是谁	发明
极乐净土的日语怎么说	极乐净土
美国队长3制作费用多少	美国队长3
刘贺的陵墓	刘贺
给我讲讲非洲本意	非洲
五证合一有哪些同义词	合一
网字的笔画多少	网
研究员有怎样的工作内容	研究员
龙珠超是哪儿的	龙珠
青岛市工商行政管理局的地点	青岛市工商行政管理局
心理健康表现是	心理健康
动物分类学用别的词怎么说	动物分类学
后来原曲是哪首	后来
木村拓哉性格	木村拓哉
王俊凯有什么技术	王俊凯
尊重的词义	尊重
东南亚国家联盟加起来多大	东南亚国家联盟
深圳地铁11号线的开通时间	深圳地铁11号线
cp最初的来源是什么	cp
vhd是由哪里延伸出来的	vhd
林丹是什么项目的运动员	林丹
绘画的元素是什么	绘画
爱奇艺外文名	爱奇艺
李昌钰的诨号有哪些	李昌钰
如何正确的使用问号	问号
河北华夏幸福足球俱乐部归属于什么联赛	河北华夏幸福足球俱乐部
不锈钢的材料是什么	不锈钢
黄河的流域是多少	黄河
检察官是哪个单位的	检察官
青岛市工商行政管理局的办公场地在哪里	青岛市工商行政管理局
unity3d被哪个公司开发的	unity3d
唐朝钱的样式是什么	唐朝
出版攻壳机动队的杂志社	攻壳机动队
那些花儿都有谁翻唱过	那些花儿
必应是干嘛用的	必应
你曾是少年是什么类别的专辑	你曾是少年
bigbang靠啥挣钱	bigbang
济南特产有哪些值得购买	南特
欧洲的原始意义是啥	欧洲
谁是w-inds.的主唱	w-inds.
雅思可以用什么英文简写来代表	雅思
乌冬面的做法	乌冬面
陶瓷是用什么做成的	陶瓷
报专业想报会计我应该去哪个系里看看	会计
玉器鉴别用什么方法	玉器鉴别
木村拓哉性格特色分别是什么	木村拓哉
新加坡翻译成英语是	新加坡
什么叫鬼畜	鬼畜
舒淇是怎样的人	舒淇
周杰伦的床边故事专辑的歌曲语言	床边故事
一帘幽梦有哪些歌星翻唱过	一帘幽梦
大熊猫的另一种说法	大熊猫
刘备的字号	刘备
河北华夏幸福足球俱乐部属于什么赛事	河北华夏幸福足球俱乐部
vlookup函数的作用不	vlookup函数
燕麦有什么样的毒性	燕麦
在相对原子质量表中ba的原子质量是多少	相对原子质量表
中央电视台的区域是怎样的	中央电视台
谁是你看不到的天空的词曲	你看不到的天空
北京南站归哪个铁路局管	北京南站
色情片有哪些等级	色情片
关于python它被发行出来的具体时间	python
南京旅游有没有景点推荐	南京旅游
蒙面唱将猜猜猜的录制现场在哪里	猜猜猜
极乐净土的日文	极乐净土
游坦之被谁教导过	游坦之
创作了欢乐颂曲子的人叫什么	欢乐颂
华山长多少	华山
中国国民党的创立时间	中国国民党
arduino的创建人是哪位	arduino
哪里有qfii	qfii
孟加拉国的国花叫什么	孟加拉国
林允的经纪公司	林允
通过什么变化出了猫咪老师	猫咪老师
陪你度过漫长岁月都是什么语言	漫长
1024是什么日子	1024
黄山算是什么级别的景点	黄山
梁海玲的名字是什么	梁海玲
张国焘的逝世地点具体是在哪儿	张国焘
辞职信的重要组成	辞职信
对数函数的特性	对数函数
甄嬛的恋人有哪些	甄嬛
朴槿惠的婚姻状况	朴槿惠
ppap的中文名称	ppap
黄致列最有名的歌	歌
第一个有电影的地方在哪儿	第
郑州的辉煌人物	辉煌
周杰伦的专辑语言	周杰伦
陪你度过漫长岁月是什么语言	漫长
唱玉米的歌手到底是谁	玉米
捉鬼记的歌曲别名	捉鬼记
游戏人生是一款什么画面的游戏	游戏人生
跳蚤之歌是谁写的	跳蚤之歌
大家又称三体为什么	三体
web的含义	web
谁是名侦探柯南剧场版的作者	名侦探柯南剧场版
美人为馅的书名是啥	美人为馅
荨麻疹的常见发病部位	荨麻疹
啥叫恶魔雪茄	恶魔雪茄
苏轼什么时候过逝的	什么时候
写信给任天堂邮编需要填什么	任天堂
宋小宝师从于谁	宋小宝
长沙有什么大学	长沙
瑞士的国家统治制度	瑞士
什么血型是林允儿的	林允儿
你最喜欢威尼斯的什么	威尼斯
改革开放对我国有什么影响	改革开放
九州·天空城的主演是谁	天空城
湖北都有哪些很著名的大学	湖北
星座的起源是怎样的	星座
iphone6s是哪家产的	iphone6s
王嘉尔的亲属成员	王嘉尔
这届法国总统谁在当	法国
欧洲原始意义为何	原始
超少年密码的播放状态如何	少年
海洋的体积有多大	海洋
罗永浩什么时候过生日	罗永浩
杨绛的闺女	杨绛
哈利·波特的系列作品名	哈利·波特
bobbytinsley的音乐流派	bobbytinsley
徐志摩第一位爱人叫什么	徐志摩
windowspowershell的操作平台是什么	windowspowershell
詹天佑是什么时候的人	詹天佑
贤者之爱每集长度是多少	贤者
熔炉的原著者	熔炉
一般都用什么进行在线翻译	在线翻译
比利时的代表花是什么	比利时
端午节吃什么好	端午节
阿衰爱好	阿衰
马云的主要成就	马云
策划制作出上古卷轴5的那个人叫什么	上古卷轴5
新海诚老家是哪儿	新海诚
大麦茶有哪些益处	大麦茶
dns劫持会发生什么	dns劫持
spring可以应用的范围是	spring
可见光的平均速度	可见光
kenarai音乐作品列表	kenarai
hao123的所属公司是哪家	hao123
切·格瓦拉的夫人叫什么名字	切·格瓦拉
microsoftonenote的发行阶段	microsoftonenote
dpi的含义	dpi
伊万卡·特朗普的爱人是哪位	伊万卡·特朗普
硫化氢的毒性是什么	硫化氢
荀彧	荀彧
解释数据结构	数据结构
唐家三少的外貌	唐家三少
谁是野子的原唱	野子
可行性研究报告的原则有哪些	可行性研究报告
伊丽莎白·巴托里的喜好	伊丽莎白·巴托里
华山有多远	华山
maven的根本属性	maven
欧洲一词的原始意义	欧洲
t恤衫是啥	t恤衫
sumif函数的表达式是啥	sumif函数
唐三的女婿	唐三
上海迪士尼乐园位于什么气候	上海迪士尼乐园
ssid的主要用途	ssid
兔子喜欢吃什么	兔子
acl的准则有哪些	acl
怎么称呼徐志摩前妻	徐志摩
pmo是干什么的	pmo
提到阴茎会想到什么	阴茎
中国旅游著名景点有什么	中国旅游
蒙奇.d.路飞的配音演员是谁	蒙奇
亚洲的别名叫什么	亚洲
梁海玲叫什么	梁海玲
搜狗是属于哪个公司	搜狗
多少地归纽约中央公园所有	纽约中央公园
托福有几种	托福
火龙果是什么目的	火龙果
沙溢媳妇叫什么	沙溢
虎牙在什么地方	虎牙
万圣节的英文	万圣节
microsoftoffice的最新版本	microsoftoffice
三味线出自哪张专辑	三味线
半月板一般会因什么而发病	半月板
关之琳的好友么	关之琳
资本指什么	资本
虎牙的具体地方	虎牙
t是谁的歌	t
一年级大学季的制作商	一年级
市净率该怎么计算	市净率
汤圆怎么做	汤圆
作者写荷塘月色是什么时候的事儿	荷塘月色
梦想的声音什么时候播出	梦想
莫文蔚喜欢的明星	莫文蔚
青云志在哪里完成制作的	青云志
酉阳杂俎是哪个朝代写的	酉阳杂俎
docker被发放的日子是什么时候	docker
dns劫持的效果	dns劫持
有哪些词语可以用到颞	有哪些词语可以用到颞
哪类文学是白夜行所代表的的	白夜行
爱新觉罗·玄烨的年号	爱新觉罗·玄烨
章泽天的男友是谁	章泽天
加拿大在几月几号过国庆节	加拿大
关之琳的好友有哪些人	关之琳
vlookup函数的功能么	vlookup函数
四糸乃的喜好	四糸乃
马东敏叫什么	马东敏
唐舞麟的妈妈是谁	唐舞
心脏搭桥手术主要治疗什么	心脏搭桥手术
东京食尸鬼本来的名字叫什么	东京食尸鬼
哪天发布的mit许可证	发
最小二乘法是谁最先发现的	最小二乘法
什么小说拍成了伪装者	伪装者
喜欢舒淇的原因是什么	舒淇
volte	volte
行尸走肉这部动画是谁做的	行尸走肉
迪拜多大不	迪拜
哪个人叫杨永信	杨永信
flytothesky的曲风是什么	flytothesky
丑八怪被编辑在哪个专辑里了	丑八怪
赵匡胤的陵墓叫什么	赵匡胤
心经的翻译	心经
1024程序员节必须做什么	1024程序员节
五证合一有什么近义词	合一
张学良是哪儿人么	张学良
甄嬛让谁当自己的恋人	甄嬛
尤克里里什么木材好	克里
张继科的主要奖项有哪些	张继科
东京住了多少人	东京
十二星座都象征着什么	十二星座
node.js的首发时间	node.js
谁是花千骨的师傅	花千骨
哪些名号是形容李昌钰的	李昌钰
海词的作用	海词
华盛顿哥伦比亚特区的所有机场	华盛顿哥伦比亚特区
adobeillustrator的首发在哪年	adobeillustrator
聚乙烯的沸点具体是多少度	聚乙烯
核工业404地主哪个地方	核工业
音乐符号的作用是什么	音乐符号
大熊猫的门类	大熊猫
亲爱的，公主病哪天开始的	亲爱的
盗墓笔记的监制人是谁	盗墓笔记
雪鹰领主的主人公是谁	领主
在哪里延伸出了vhd	vhd
尤克里里的制作材质是什么	克里
加利福尼亚州好玩地方推荐	加利福尼亚州
张若昀歌曲作品	张若昀
南北朝曾定都于哪儿	南北朝
拉希奥所在的位置在哪里	拉希奥
matlab写全了是什么	matlab
张宇恩师	张宇
任天堂在邮局的代号	任天堂
青春指什么意思	青春
巴黎的主要宗教是什么	巴黎
内容分发网络的条件有	内容分发网络
苏联的国家领袖是谁	苏联
从哪看到的美丽新世界	美丽新世界
qq邮箱的外文	qq邮箱
投名状制作成本是多少	投名状
三毛的丈夫	三毛
核心期刊的理论是什么	核心期刊
smart原则是哪本书定义的	smart原则
铝合金的熔点	铝合金
茯苓有没有毒	茯苓
什么地方才会用到幻灯片版式	幻灯片
126的概况	126
pthread_cond_wait的搭配对象是什么	pthread_cond_wait
萌萌哒天团开创地点在哪里	萌萌哒天团
都谁唱过游击队歌	游击队歌
谁是苏秦的老师	苏秦
哪个国家研发的长征五号系列运载火箭	长征五号系列运载火箭
关于facebook你知道它是个什么性质的公司	facebook
湖北的名校都有什么	湖北
新闻有哪些同义词	新闻
陆雪琪的男人	陆雪琪
劳尔·卡斯特罗的兄长	劳尔·卡斯特罗
什么样的爱好是奚梦瑶所拥有的	奚梦瑶
蓝胭脂她爹叫什么名字	胭脂
捉鬼记别名	捉鬼记
克里斯汀·斯图尔特是什么血统的	克里斯汀·斯图尔特
歌诗达邮轮带给我们一种什么样的风情	歌诗达邮轮
说几个微软的主要产品	微软
武动乾坤的主要人物有哪些	武动乾坤
阿特拉斯的有关故事	阿特拉斯
腾讯的总裁是谁	腾讯
李飞飞的职位	李飞
比热容的单位属性是什么	比热容
毛泽东辞世的时间	毛泽东
bigbang属于哪个国家的	bigbang
章泽天的男朋友你知道是谁	章泽天
谁是参商的演唱者	参商
里番表示什么	里
萌萌哒天团在哪里开创	萌萌哒天团
lorde的演唱风格	lorde
人字的四角号码是多少	少
古代的梅兰芳是哪个民族的	梅兰芳
flytothesky的音乐是什么风格	flytothesky
李昌钰的别名有什么	李昌钰
小米note的定价是多少	小米note
桃谷绘里香的星座	桃谷绘里香
雪中悍刀行哪年首发	雪中悍刀行
提起歌诗达邮轮脑中是什么样的画面	歌诗达邮轮
谁翻译的冰与火之歌	冰与火之歌
yy语音的总裁	yy语音
appletv值多少	appletv
赵云是什么朝代的人	赵云
唐朝的钱是什么吧	唐朝
唐舞麟的母亲叫什么名字	唐舞
钱都从哪融的	钱都
文明5在哪些对战平台上可以玩	文明5
黄景瑜什么时候过生日	黄景
立体电影有哪些名称	立体电影
想听丑八怪去哪个专辑里找	丑八怪
玻璃的主要化学成分是什么	玻璃
冰菓的制片	冰菓
麻雀的拍摄地是哪儿	麻雀
生死狙击能几个人玩	生死狙击
性格的英语表达方式	性格
fyi怎么解释	fyi
欢乐颂这首曲子的创作者是谁	欢乐颂
龙珠超的地区位于哪里	龙珠
喜欢你的原唱	喜欢你
谁发行的魔幻车神	车神
秦烈交过的女朋友有谁	秦烈
赵雅淇有什么样的三围	赵雅淇
改革开放意味着什么	改革开放
滕王阁序是什么样式的文学	滕王阁序
瑜伽日具体是什么时候	瑜伽
简单爱的合声编写是谁	简单爱
静电起的作用	静电
李相赫有哪些外号	李相
担仔面的主要食材是什么	担仔面
制作十二道锋味第二季的是什么公司	十二道锋味
摩尔斯电码的发明人是谁	摩尔斯电码
1号店公司都有什么励志口号	1号店
黑洞的直径	黑洞
胡歌的祖籍么	胡歌
c语言的发源	c语言
太阳的表面温度是多少	太阳
巴厘岛的方言	巴厘岛
择天记发布的首个网站是什么网	择天记
网字总共多少笔画	网
新西兰什么钱可以用	新西兰
哪句话能代表58同城的品牌定位	58同城
天津人说的是什么话	天津人
李世民庙号信息	李世民
瓜德尔港位于哪个城市	瓜德尔
给下百度糯米的定位	百度糯米
谁是江户川柯南的演员	江户川柯南
绿罗裙是谁的歌	绿罗裙
雪儿唱歌什么风格	雪儿
天安门哪年开始动工的	天安门
神奇动物在哪里是哪位编剧写的	神奇动物
色情片的级别分类	色情片
hao123的所属公司是哪家	hao123
直男癌的来源	直男癌
统治过宋朝的有哪些	统治
巴霍巴利王制作费多少钱	巴利
邓紫棋喜欢吃哪些食物	邓紫棋
中山的市花是什么	中山
赵敏的扮演者	赵敏
node.js的发布时间	node.js
qq音乐开放商	qq音乐
神司马懿的作用是什么	神司马懿
问号的正确使用方式是什么	问号
迪士尼最重要的地方在哪	迪士尼
海词词典年份信息	海词词典
毛泽东什么时候离世的	毛泽东
site	ite
youtube由多少人组成的	youtube
胰岛素分子式怎么写	胰岛素
赵匡胤的陵园	赵匡胤
site该怎么解释	ite
数据结构有什么作用	数据结构
dns劫持的效果是什么	dns劫持
什么样的做法能让汤圆好吃	汤圆
黄致列的歌推荐听什么	黄致列的歌
讲讲ce认证的含义	ce认证
路德维希·凡·贝多芬活了多少岁	路德维希·凡·贝多芬
des的类型	des
动物分类学又被称为什么	动物分类学
李昌钰因什么名头而为人所知	李昌钰
罗敏庄与谁在一起了	罗敏庄
关之琳的好友都有谁	关之琳
重定向的操作方法	重定向
bilibili的创建人	bilibili
s原子的相对原子质量是多少	少
安庆都有什么学校	安庆
孤独翻译成英语是怎样的	翻译
seeyouagain是谁制作的	seeyouagain
自传的专辑歌手是谁	自传
神吕布的技能	神吕布
谁唱了游击队歌	游击队歌
谁是小别离制片人	小别离
qq空间版本号是什么	qq空间
联想集团到底属于哪个国家	联想集团
百度百科的公司	百度百科
自来也爱的人是谁	自来也
imaginedragons的定位是什么	imaginedragons
c语言是从什么基础上研究出来的	c语言
谁是维密天使的顶梁柱	维密天使
麻生希平时都喜欢干什么	麻生希
ssid主要是用来干什么的	ssid
刺客信条：大革命的主角么	刺客信条：大革命
徐志摩前妻是谁	徐志摩
www是什么意思	www
中国好声音第五季是档什么类节目	中国好声音第五季
罗永浩的生日是什么时候	罗永浩
华为技术有限公司的成立年份	华为技术有限公司
画江湖之不良人的音乐创作人	画江湖之不良人
立体电影的英文简称是	立体电影
赵敏被谁饰演过	赵敏
极限挑战播出了	极限挑战
李晨现在喜欢谁	李晨
啥时候演妖精的尾巴	候
websocket不	websocket
喜欢你原唱来自哪个歌手	喜欢你
白夜行是什么小说	白夜行
民族乐派是什么时代的	民族乐派
平时哪些习惯会导致半月板生病的	半月板
乌冬面可以怎么做	乌冬面
杭州一共占地多少平方米	杭州
谁是王健林的母亲	王健林
潘金莲是什么朝代的	潘金莲
李白本来的名字叫什么	李白
黑羽的英文是什么	黑羽
饰演猪八戒的演员都有谁	猪八戒
ebsco跟哪儿	ebsco
大麦茶的益处	大麦茶
3d肉蒲团之极乐宝鉴这部片子是由谁出品的	3d肉蒲团之极乐宝鉴
青岛的车牌代码	青岛
余罪每集时间长度	余罪
王家卫的家属	王家卫
农业电子商务现在大体的状况	电子商务
网字的总笔画是多少画	网
吴亦凡的体重	吴亦凡
守望先锋在哪被做出来的	守望先锋
荷塘月色这部作品的创作时间	荷塘月色
microsoftoffice最新版是哪个	microsoftoffice
鹿晗国籍么	鹿晗
赵雷是什么流派的	赵雷
菲德尔·卡斯特罗生日是哪天	菲德尔·卡斯特罗
巴洛克音乐什么年代流行	巴洛克音乐
蓝色大海的传说用中文怎么说	大海的传说
张国焘的去世地点	张国焘
乌台诗案的时间大概是在什么时候	乌台诗案
刘亦菲昵称	刘亦菲
长白山脉中拥有最高的山顶是哪个峰	长白山脉
哪个机场在张家界	张家界
谍影重重有着怎样的分级	谍影重重
朋克来源于什么年代	朋克
websocket是啥	websocket
买什么材质的尤克里里音色好点	克里
自来也爱那个人	自来也
威风堂堂的编曲	威风堂堂
在朝鲜能花什么钱	朝鲜
秦时明月之君临天下的其他名称是什么	秦时明月之君临天下
亚洲的意译还有啥	亚洲
关于mit许可证的发布你知道是什么时间	mit许可证
临江仙是什么时期流传下来的	临江仙
cvt的工作方法是什么	cvt
项羽是哪个族群的	项羽
皇家马德里足球俱乐部的头儿是谁	皇家马德里足球俱乐部
幻灯片通常还能代表什么	幻灯片
柏拉图有哪个老师	柏拉图
大鱼海棠的电影成本是多少	海棠
互联网的概念是什么	互联网
巴基斯坦都有什么民族	巴基斯坦
托福几种考法	几种
聚乙烯最高达到多少度才是它的沸点	聚乙烯
组策略的应用领域	组策略
mit许可证啥时候发布的	mit许可证
魔兽世界是谁在运营	魔兽世界
seo的发明时间是什么时候	seo
王维的拿手作品	王维
辞职信的构成是什么	辞职信
舒淇的性格特点	舒淇
江苏的省会城市是	江苏
操作系统由什么组成	操作系统
大麦茶有什么功效	大麦茶
澳门风云3是哪种语言	澳门风云3
哪首歌是加利福尼亚大学伯克利分校的校歌	加利福尼亚大学伯克利分校
张宇师承于谁	张宇
解释下恶魔雪茄	恶魔雪茄
扎马斯的师傅叫什么	马斯
唐三的那个女婿叫什么	唐三
还能用哪几个词替代二八定律	二八定律
大学问是谁的作品	大学问
民族乐派的诞生时代	民族乐派
银魂的出版期间	银魂
拉面的作法	拉面
想看妖精的尾巴需要等到什么时候	妖精的尾巴
什么样的性格木村拓哉所拥有的	木村拓哉
喜欢你的原唱是谁	喜欢你
谁写出了奇妙能力歌的词	奇妙能力歌
寒战2哪天开始拍摄	寒战2
能介绍下jenkins么	jenkins
京韵大鼓由什么地方流行下来	京韵大鼓
转义字符还叫什么	转义字符
澳大利亚前3大城市是什么	澳大利亚
进行在线翻译都用哪些工具	在线翻译
旧金山的时区是什么	旧金山
神印王座的画者是哪位	神印王座
太阳的地表温度	太阳
bose公司在哪	bose
歌剧魅影的词作者	歌剧魅影
淘宝什么时候成立的	宝
诸葛亮去世的日子	诸葛亮
乌冬面有什么烹饪方法	乌冬面
中国梦	中国梦
哪些名校座落在湖北	湖北
哪是儿4399小游戏的总部	4399小游戏
李白自己的真名是什么	李白
高铁多少迈	少
唐纳德·特朗普的信仰	唐纳德·特朗普
三毛的老公	三毛
赵雅淇三围多少	赵雅淇
公主头是如何被划分的	公主头
静电能带来什么很好的效果	静电
ascii全名是	ascii
欢乐颂的谱曲是谁	欢乐颂
拉布拉多猎犬都生活在哪里	拉布拉多猎犬
谁是沈腾的姐姐	沈腾
英魂之刃是什么样的电影	英魂之刃
匈牙利最重要的银行	匈牙利
游戏人生给人带来的是什么画面感	游戏人生
哪家公司发行的windows10	windows10
怎么吃b族维生素才算是合理	b族维生素
哪些科目涉及到机器学习	机器学习
pmo	pmo
adobeillustrator哪年第一次发布的	adobeillustrator
猫咪老师的原形是什么	猫咪老师
那些曾考上麻省理工学院大学的名人都有谁	麻省理工学院
鹿晗的国籍	鹿晗
latex的属性是什么	latex
哪种品牌里包含博柏利	博柏利
滕王阁序是属于什么体裁	滕王阁序
谁是沙溢的老婆	沙溢
数据库是什么意思	数据库
在哪些杂志上能看到哆啦a梦	哆啦a梦
林丹是从事哪个项目的运动	林丹
奔跑吧兄弟是谁录音的	奔跑吧兄弟
洋葱的食用方法	洋葱
哪位是希尔瓦娜斯·风行者的姐姐	希尔瓦娜斯·风行者
静电值得去称赞的地方	静电
介绍兔子的动物属性	兔子
张继科的主要奖项是什么	张继科
农历由哪里流传下来	农历
bobbytinsley的歌曲曲风是什么	bobbytinsley
不锈钢有哪些材质	不锈钢
生死狙击的玩家总人数是多少	生死狙击
黄山的景点级别是什么	黄山
爱新觉罗·玄烨在位时期的年号称作什么	爱新觉罗·玄烨
走着走着就散了师哪个混音师录得	走着走着就散了
web有什么重要的意义	web
qq空间版本是什么	qq空间
未央宫建筑一共多少面积么	未央宫
百度公司的全名叫什么	百度公司
北京的所属地区	北京
哪个是杨绛的女儿	杨绛
张宇的老师是谁	张宇
可行性研究报告的准则	可行性研究报告
tellmewhy专辑是什么类别	tellmewhy
万圣节的英语是什么	万圣节
无题的文体	无题
草榴社区创建时间	草榴社区
阿特拉斯有什么故事	阿特拉斯
雪鹰领主里的主角是谁	领主
介绍七鳃鳗的食性	七鳃鳗
王牌逗王牌的对话语言	的对
三体又叫	三体
听说马思纯是回族的，是不是真的	马思纯
全民超神在哪个网站下载游戏	超神
王俊凯在什么地方很厉害	王俊凯
宋智孝的属相	宋智孝
中山最有名的花是	中山
荷塘月色这部作品被创作于什么时候	荷塘月色
dns劫持会导致什么情况的发生	dns劫持
世界名人中哪些都是犹太人	世界名人
核心期刊的理论基础	核心期刊
谁是被木心教出来的	被
百度公司的全称	百度公司
二八定律还可以怎么说	二八定律
比亚迪唐的首发时间是什么时候	比亚迪唐
谁是唐三的女婿	唐三
谁是你看不到的天空的词曲者	你看不到的天空
白鹿原首版是什么时候	白鹿原
法国主要民族简介	法国
香港的电话区号	香港
宇宙的直径	宇宙
白茶的主要产区在哪	白茶
美人鱼还叫什么	美人鱼
蜂蜜的主要成分是什么	蜂蜜
maven实质上是什么	maven
培养了薛之谦的是哪个学校	薛之谦
绝命毒师获得奖项	绝命毒师
法国人数第一的民族是哪个民族	法国人
锡克教什么地方流传	锡克教
马思纯的民族是什么	马思纯
堂吉诃德的作曲者是	堂吉诃德
画江湖之不良人的音乐人	画江湖之不良人
农业电子商务正在经历什么	电子商务
不为谁而作的歌的曲风	歌
法医秦明在哪放的	法医
关于二八定律还有相似的词语	二八定律
websocket代表什么意思	websocket
陈赫口头禅是什么	陈赫
李白原本叫什么	李白
乌台诗案的时间	乌台诗案
喝大麦茶的作用是什么	大麦茶
比热容是什么	比热容
thebeatles的乐风	thebeatles
海洋的体积	海洋
后来的原版	后来
呼斯楞的演唱风格	呼斯楞
163邮箱作用是啥	163邮箱
赵一荻的配偶是谁	赵一荻
美丽新世界的出处是哪	美丽新世界
济南特产哪些比较好	南特
方差的计算模式有哪些	方差
王嘉尔的家属都有谁	王嘉尔
哪儿是张学良的老家	张学良
毛泽东归西的日子	毛泽东
博柏利的定位在类别里	博柏利
林志颖的妈妈是哪位	林志颖
valve员工数	valve
英国的首相是谁	英国
对数函数的特点	对数函数
比亚迪股份有限公司拥有多大的面积	比亚迪股份有限公司
金木研的出生日期	金木研
美元是谁发行的	美元
大熊猫的门类	大熊猫
杀生丸爱人	杀生丸
iphone6s是什么公司的	iphone6s
波雅·汉库克喜欢的人的名字叫什么	波雅·汉库克
w-inds.的主唱是谁	w-inds.
3d打印的发明人	3d
黑洞直径	黑洞
杜鹃会什么	杜鹃
运动鞋能起到的好作用	运动鞋
ascii的全称是什么	ascii
bootstrap属于哪个分类	bootstrap
微微一笑很倾城是什么颜色的	微微一笑很倾城
1024是什么节	1024
法国人口最多的民族是哪个民族	法国人
巴洛克音乐流行时间	巴洛克音乐
七海千秋喜欢什么	七海千秋
八达岭长城属于什么样的气候	八达岭长城
谁创作的林中鸟	林中
龚琳娜的爱人	龚琳娜
塞浦路斯的英文写法	塞浦路斯
杨幂签的是哪家唱片公司	杨幂
幻灯片版式是什么里面有的	幻灯片
中国平安保险董事长名字	平安保险
什么名字也代表三体	三体
为什么要穿运动鞋	运动鞋
色情小说的要求	色情小说
亚洲足球锦标赛举行的地点是哪儿	亚洲足球
鸡蛋果属于哪个属类的	鸡蛋果
林允儿是什么血的	林允儿
黑语的外文	语
洛阳有哪些高等院校	洛阳
纽约中央公园的占地	纽约中央公园
唱游击队歌的歌手	游击队歌
qq邮箱的英文怎么说	qq邮箱
mfc的使用群体有哪些	mfc
唯品会的语言种类	唯品会
东京食尸鬼的原版日文名字是什么	东京食尸鬼
济南特产是什么	济南
中东信仰的宗教是什么	中东
杨绛的女儿	杨绛
洋葱的做法	洋葱
章泽天的男朋友到底是谁	章泽天
伏地魔有多少岁	伏地魔
微微一笑很倾城有着怎样的颜色	微微一笑很倾城
发出了金瓶梅的公司	金瓶梅
西伯利亚雪橇犬的种群是什么	西伯利亚雪橇犬
磁力链接的应用领域	磁力链接
什么时间t-ara出道的	t-ara
茯苓有毒不	茯苓
王健林的妈妈	王健林
希尔薇什么时候出生的	希尔
波雅·汉库克喜欢哪个不	波雅·汉库克
androidstudio的更新日期	androidstudio
ascii是什么	ascii
多少钱可以买appletv	appletv
幻灯片另一个身份	幻灯片
哪年定的元旦	定
徐志摩前妻名字	徐志摩
怎么用问号	问号
自然常数公式是什么	自然常数
wechat最终解释国是谁	wechat
哈利·波特的作品有哪些名字	哈利·波特
杨永信性别么	杨永信
完美世界是在哪里出版的	完美世界
内科的治疗方法	内科
长江长度	长江
李相赫还可以叫什么	李相
大熊猫别名有哪些	大熊猫
能逆转时空的闪电侠有没有别的能力	逆转时空
里番	里番
鬼节的设定日期	鬼节
哪个系统被植入了iphone7中	iphone7
色情小说有什么主要要求	色情小说
洋葱的制作方法	洋葱
陈思诚属什么的	陈思诚
行尸走肉是谁画的	行尸走肉
冰与火之歌的译者	冰与火之歌
澳门风云3是哪个语种	澳门风云3
蒋雯丽的爱人么	蒋雯丽
爱新觉罗·玄烨的年号是什么	爱新觉罗·玄烨
一人我饮酒醉有多长时间	一人
釜山行用韩语怎么说	釜山行
给我查查广州邮编	广州
太阳的表面温度	太阳
黄河有多长	黄河
香港的电话区号是什么	香港
荨麻疹最先出疹的部位是哪里	荨麻疹
尊重	尊重
银魂出版的时间	银魂
foxmail叫啥不	foxmail
谁是日本的首都	日本
贝加尔湖几米能到湖底	贝加尔湖
路西法来源	路西法
3d肉蒲团之极乐宝鉴投资人	3d肉蒲团之极乐宝鉴
哪家公司旗下有搜狗	旗下
华盛顿哥伦比亚特区有哪些机场	华盛顿哥伦比亚特区
该怎么使用sleep函数	sleep函数
黄景瑜的生日是什么时候	黄景
多高才算是金毛寻回犬	寻回犬
马东敏是谁	马东敏
关于四分位数的几个例子	四分位数
顺丰速运总公司在哪里	顺丰速运
什么可以用.xxx来表示	.xxx
黄河大概有多少米	黄河
网易公司的股票上市号码是什么	网易公司
澳门的总人数么	澳门
bootstrap的类型么	bootstrap
acfun的营销口号是什么	acfun
爱奇艺外文名怎么说	爱奇艺
郑州的名人分别都有谁	郑州
王嘉尔的亲属成员有谁	王嘉尔
绝世唐门的分类	绝世唐门
有没有四分位数的例子	四分位数
雪鹰领主的主人公你知道名字	领主
发行走向共和的都有哪	行走
头条号有着怎样的网站口号	头条
御坂美琴有什么技能	御坂美琴
维生素a的物理状态	维生素a
摩洛哥的人口数量	摩洛哥
哪些问题容易导致高血压	高血压
什么是唾液	唾液
裴秀智有哪些擅长的运动	裴秀智
德国国歌叫什么	德国
我想去华东师范大学	华东师范大学
1号店给员工定的目标口号是哪句	1号店
乳腺结节治疗的方法有哪些	乳腺结节
谁写的梦田合声	梦田
律政强人剧本谁写的	强人
简单爱的合声编曲	简单爱
麻雀是在什么地方拍的	麻雀
树莓派的其他说法是什么	树莓派
白茶是什么地方生产的好些	白茶
萨尔的坐骑	萨尔
9·11事件出事地点	9·11事件
听说过翻译过冰与火之歌的人	冰与火之歌
广州邮编么	广州
铁凝到底姓什么	铁凝
哪里是电影的发源地	电影
法国主体民族简介	主体民族
是谁把windows10发行出来的	windows10
张起灵的祖父是谁	张起灵
釜山行的英文	釜山行
latex的性质	latex
天气一般指什么	天气
百度百科隶属于哪个公司	百度百科
虚拟现实的简称是什么	虚拟现实
b族维生素的标准服用方法	b族维生素
语音的关键是什么	语音
犯罪心理到哪季了	犯罪心理
邓紫棋爱吃什么	邓紫棋
如何正确使用sleep函数	sleep函数
华为技术有限公司是什么时候成立的	华为技术有限公司
玻璃是由什么物质组成的	玻璃
希拉里·黛安·罗德姆·克林顿最高学历	希拉里·黛安·罗德姆·克林顿
富士康是谁的产业	富士康
cp这个词是从哪里流行的	cp
用颞字组词	颞
有冬至的季节	冬至
voc的危害有哪些	voc
我需要ysl官网	ysl
里番如何解释	里番
什么年代有的富春山居图	富春山居图
崔健的唱片公司是什么	崔健
苏州总人数是多少	苏州
我的奇妙男友编剧是谁不	奇妙
秦时明月之君临天下的中文名称是什么	秦时明月之君临天下
说一说戚继光的典故	戚继光
幻灯片还有什么意思	幻灯片
国歌的歌曲风格	国歌
runtimeerror的通病	runtimeerror
黑豹乐队的鼓手信息	黑豹乐队
玩台儿庄古城需要多少钱	台儿庄古城
万圣节的外语	万圣节
王家卫的亲属成员	王家卫
侠盗猎车手5的所属作品	侠盗猎车手5
什么网站连载了灵能百分百	灵能百分百
淘宝网的成立时间是什么	淘宝网
内容分发网络的基础	内容分发网络
互联网是什么意思	互联网
模特的作词是哪位	模特
上海迪士尼乐园到底是什么气候	上海迪士尼乐园
bigbang是哪儿的	bigbang
谁给权力的游戏砸的钱	权力
迈克尔·乔丹的孩子叫什么	迈克尔·乔丹
gopro相机发明者	gopro相机
谁是你看不到的天空的作词作曲	你看不到的天空
欢喜密探的导演	欢喜
三极管是用什么材料做成的	三极管
日本的首都在哪里	日本
pdca循环	pdca循环
方大同的曲风	方大同
空气质量指数划分为	空气质量指数
谁是刘承羽的老师	刘承
贝加尔湖水深多少米	贝加尔湖
新西兰有着怎样的货币	新西兰
ascii是什么的简称	ascii
皇家马德里足球俱乐部的队长是谁	皇家马德里足球俱乐部
日本的首都	日本
哪个星座是易烊千玺的星座	易烊千玺
赵一荻跟谁结的婚	赵一荻
1988一共多少集	1988
唐人街探案的制片人是谁	唐人街
美人为馅的书名么	美人为馅
什么月份属于金牛座	金牛座
ncbi是哪个国家的	ncbi
w-inds.中谁是主唱	w-inds.
哪个版本的qq空间可以用	qq空间
t-ara出道年份是	t-ara
www的属性有哪些	www
成都的电话区号	成都
灵能百分百在哪连载的	灵能百分百
中国梦的思想是什么	中国梦
王家卫的亲属成员有谁	王家卫
守望先锋厂商	守望先锋
1怎么读	1
发现正态分布的叫啥	正态分布
中国好声音第五季那个到底是什么类型的电视节目	中国好声音第五季
苏小妹有哪个父亲	苏小妹
于魁智的单位是哪儿	于魁智
江苏省会是哪个城市	江苏省
蓝染惣右介花语的含义	蓝染惣右介
谁能告诉我希尔薇多大了	希尔
唐人街探案的制片人	唐人街
刘慈欣到底是什么官	刘慈欣
天宫一号的长度	天宫一号
张起灵的爷爷是谁	张起灵
老舍还有没有别的名字	老舍
城寨英雄是谁监督运作起来的	英雄
铁凝的姓是什么	铁凝
氨基酸专业叫什么	氨基酸
构成操作系统都需要什么	操作系
神印王座的漫画作者	神印王座
鬼畜的含义是什么	鬼畜
蓝莓的益处	蓝莓
jira由谁生产制造出来的	jira
nba是什么时候出现的	nba
范冰冰有着什么样的血	范冰冰
萨尔的坐骑是什么	萨尔
守望先锋哪做的	守望先锋
网盘有什么技术	网盘
我想做蒲笋都需要准备什么	蒲笋
gopro谁做的	opr
iphone6s品牌是什么	iphone6s
九州·天空城的主演名单	天空城
microsoftvisualc++是由哪家公司带到世界上的	microsoftvisualc++
秋葵种类名	秋葵
rsa算法的发明人是	rsa算法
电影里面的007最喜欢喝什么样的酒	007
哪个学校是姜思达的母校	姜思
有没有游戏平台可以联机文明5	5
伊利诺伊大学厄巴纳-香槟分校的学校属性	伊利诺伊大学厄巴纳-香槟分校
介绍王思聪的爸爸	王思聪
1的拼音怎么拼	1
化学元素ba的原子量	化学元素
电影的发源地是哪儿	电影
哪些人是武动乾坤中的核心人物	武动乾坤
为微微一笑很倾城烧钱的是哪个公司	微微一笑很倾城
农业电子商务处于什么状态	电子商务
网字多少笔	网
青年的节日是哪天	青年
关于126的一些简介能告诉我	126
microsoftonenote现在是怎样的发行状态	microsoftonenote
1024程序员节有什么习俗	1024程序员节
绘画的元素	绘画
在哪建设的复旦大学	复旦大学
拾穗者哪年过世的	拾穗者
知网是干什么的	知网
大熊猫有多少种说法	大熊猫
你曾是少年的专辑类别	少年
什么画面表现了英魂之刃	英魂之刃
谁是windows10的发行商	windows10
都读麻省理工学院后来又很出名的人都有谁	麻省理工学院
万圣节用外语怎么说	万圣节
个人简历里存在什么	个人简历
jira的出品方	jira
都有哪些名人读过麻省理工学院	麻省理工学院
哪里是玉皇大帝住的	玉皇大帝
把unity3d生产出的公司的名字	unity3d
透明质酸的化学式	透明质酸
饰演江户川柯南的是谁	江户川柯南
举重妖精金福珠的首播时间	妖精
什么地点举行美国大选	美国
聚丙烯的化学式怎么写	聚丙烯
斯里兰卡的面积是怎样的	斯里兰卡
讲讲bootstrap的类型	bootstrap
在唐朝用什么买东西	唐朝
纳兰性德的字号么	纳兰性德
硫化氢的毒性有多强	硫化氢
123是什么	123
哪年t-ara出道的	t-ara
切·格瓦拉跟谁是两口子	切·格瓦拉
李嘉诚的爱人叫什么	李嘉诚
日本首都叫什么	日本首都
文殊菩萨用什么动物当的坐骑	文殊菩萨
六味地黄丸的功用	六味地黄丸
有材质好的尤克里里	克里
哪位编剧写的神奇动物在哪里	剧
jquery最新出的是什么	jquery
拙政园有多大	拙政园
李晨的女友是谁吧	李晨
波雅·汉库克喜欢的人叫什么	波雅·汉库克
编花篮的作曲是谁	编花篮
解释一下volte是什么	volte
田馥甄她的粉丝昵称是什么	田馥甄
皇家马德里足球俱乐部的队长是谁	皇家马德里足球俱乐部
林夕的祖辈一直居住在哪	林夕
星座从哪儿来的	星座
方大同的音乐风格是什么	方大同
赵雷流派	赵雷
民族乐派出现在哪个年代	民族乐派
可乐的害处有哪些	可乐
哪些是论文的要求	论文
金牛座的出生时间	金牛座
9·11事件具体位置	9·11事件
卢旺达种族大屠杀有多少人被伤亡	卢旺达种族大屠杀
搜狗母公司是哪家	搜狗
吴亦凡体重么	吴亦凡
崔健加盟哪家唱片公司	崔健
邓紫棋喜欢吃什么	邓紫棋
陈寅格生活的年代是	生活
一加手机的屏幕大小	一加手机
杨永信的性别么	杨永信
唐纳德·特朗普信奉什么	唐纳德·特朗普
奇迹暖暖联机平台是	奇迹暖暖
江苏的省会叫什么	江苏
固态硬盘主要由什么构成	固态硬盘
如何制作贵金属	贵金属
s原子的相对质量能告诉我	原子
碳酸氢钠大概多少克有一立方厘米那么大	碳酸氢钠
volte是啥意思	volte
beyond里面谁跟黄家驹是亲戚关系	beyond
柠檬初上是哪些人制片的	柠檬
腰椎间盘突出症是哪个部位不舒服	腰椎间盘突出症
加拿大人在几月几号过国庆节	加拿大人
云盘是根据什么设计的	云盘
pmo有什么用	pmo
哪位是神奇女侠的父亲	女侠
pmc	pmc
美丽的神话是哪一家唱片公司版权	美丽的神话
滨崎里绪踏足娱乐圈的时间	滨崎里绪
跟哪儿拍的麻雀	麻雀
胡歌的老家在哪儿	胡歌
哪天第一次知道的mit许可证	第一次
做担仔面的话需要准备什么材料	担仔面
讲讲谁是希尔瓦娜斯·风行者的姐姐	希尔瓦娜斯·风行者
赵雅淇的身材是怎样的	赵雅淇
谁唱的参商	参商
神奇女侠的老爹	神奇女侠
巴霍巴利王制作成本有多少	巴利
通勤最初是干嘛的	通勤
心理健康有哪些状态	心理健康
哪天开始播的亲爱的，公主病	亲爱的
西游记属于哪类体裁	西游记
玛丽苏的同义词有哪些	玛丽苏
b族维生素的用法用量	b族维生素
柏拉图的师父是	柏拉图
rename在什么地方会出现	rename
徐志摩有哪位前妻	徐志摩
那个威风堂堂的编曲者的名字是什么	威风堂堂
谁是黑豹乐队的鼓手	黑豹乐队
网字有多少笔画	网
百度百科的母公司	百度百科
戚继光典故有哪些	戚继光
web的意思	web
荷塘月色的创作年代	荷塘月色
瑜伽的节日是多会儿	瑜伽
为了预防半月板生病需要注意哪些	半月板
周深最喜欢谁的歌	周深
张国焘的逝世地点	张国焘
svchost.exe是哪家公司的服务	svchost.exe
成立g20峰会是什么时候	g20峰会
冰菓的生产者和管理者是谁	冰菓
什么时候过圣诞节	圣诞节
担仔面是拿什么做出来的	担仔面
天津的土话都有哪些	天津
是谁发明了php	php
古剑奇谭的监制叫什么	古剑奇谭
树懒的科目	树懒
谁是李嘉诚的夫人	李嘉诚
自来也暗恋的是谁	自来也
聚氯乙烯呈现什么颜色	聚氯乙烯
草榴社区初始于什么时间	草榴社区
关于大鱼海棠的制作成本	海棠
docker是什么时候正式与我们见面的	docker
咖喱什么味儿	咖喱
魔兽拍摄日期	魔兽
美国总统的定义	美国总统
老友记的主题曲是什么	老友记
美国队长3制作费是多少	美国队长3
林俊杰信什么教	林俊杰
唐家三少的长相	唐家三少
张起灵的祖父是哪位	张起灵
禁止的爱出品国家是	国
英雄联盟的游戏类型	英雄联盟
希尔薇多大岁数	希尔
产生了国有企业改革的原因	国有企业改革
天气还有哪些学名	天气
长征持续了多长时间	长征
什么钞票是朝鲜的	朝鲜
石进的现居地是哪儿	石进
谁唱的葛雷·奥特曼	葛雷·奥特曼
唐家三少的仪表怎么样	唐家三少
哪家公司是龙珠直播的主办单位	龙珠
谁是黑豹乐队的鼓手	黑豹乐队
玛丽苏的同义词有几个	玛丽苏
ip地址的类型	ip地址
英雄联盟属于什么网游	英雄联盟
谁是蒋雯丽的老公	蒋雯丽
组策略是什么领域用的	组策略
美元指数的来源	美元指数
机械键盘的特点有什么	机械键盘
演员的英文	演员
运动鞋会带来什么好处	运动鞋
举例说明四分位数	四分
梅毒会有哪些传播途径	梅毒
美国队长3生产成本是多少	美国队长3
复旦大学的校址	复旦大学
择天记发布的首个网站	择天记
facebook是什么性质的公司	facebook
刘邦时候什么去世的	刘邦
锦绣未央多少钱	锦绣未央
电视剧的拼音怎么拼	电视剧
加利福尼亚大学伯克利分校的校歌是什么	加利福尼亚大学伯克利分校
熊猫烧香是谁做的	熊猫烧香
百度云的国语念法	百度云
比亚迪唐的首发时间是	比亚迪唐
gopro相机发明者是谁	gopro相机
怎么做到4k对齐	4k对齐
从你的全世界路过一共多少分钟	从你的全世界路过
唐纳德·特朗普信仰什么	唐纳德·特朗普
御坂美琴会做什么	御坂美琴
静电的神奇之处	静电
小米手机5的系统	小米手机5
新西兰的货币是怎样的	新西兰
c语言是由什么衍生出来的	c语言
疯巫妖的实验日志第一次是从哪发布的	疯巫妖的实验日志
陶瓷是由什么物质组成的	陶瓷
实行改革开放有什么意义么	改革开放
这样爱了版权是哪家唱片公司	这样爱
锦绣未央的价格	锦绣未央
那个发现了正态分布的人叫什么	正态分布
色情片是什么级的	色情片
奇门遁甲号称有什么标签	奇门遁甲
苏小妹的爹	苏小妹
什么才能组成固态硬盘	固态硬盘
借记卡怎么用吧	借记卡
lorde的唱歌风格	lorde
都有哪些途径去进行融资	融资
法国主要民族有哪些	法国
景行厅男孩专辑有哪些曲目	景行厅男孩
你懂引号表示什么	引号
诗经还有哪些名字	诗经
啥时候创办的人民日报	创
农业电子商务正在面临什么	电子商务
哈利·波特是哪个作品里的	哈利·波特
开发qq音乐的是谁	qq
哪制做的十二道锋味第二季	十二道锋味
路西法最开始从哪出现的	路西法
田馥甄是哪些人的爱豆	田馥甄
菲德尔·卡斯特罗是哪年生人	菲德尔·卡斯特罗
手术疤痕怎么治	手术疤痕
vhd属于哪里	vhd
visa还有别的翻译方式	visa
借记卡怎么用	借记卡
非洲本意	非洲
谁做了魔兽世界	魔兽世界
车牌上的什么代表青岛	车牌
麻雀归属于哪个种	麻雀
蓝色大海的中文名	蓝色大海
长城的地理位置	长城
青岛市工商行政管理局的办公地点在哪里	青岛市工商行政管理局
游戏人生的游戏画质	游戏人生
扮演猪八戒的人是谁	猪八戒
windows.old的位置能告诉我	windows.old
金茂大厦的总高是多少	金茂大厦
跟三毛结婚的是谁	三毛
那个中国好声音第五季分在哪个类别的电视节目里	中国好声音第五季
蒙面唱将猜猜猜是哪个国家的娱乐节目	猜猜猜
食用拿铁有哪些不良反应	拿铁
ig的boss是	ig
哪年发行的python	python
小别离制片人姓名	小别离
天气的涵义有哪些	天气
马思纯是哪个民族的	马思纯
蔡依林的唱片达到了多少销量	蔡依林
项羽的族类	项羽
洛杉矶的火车站	洛杉矶
strstr的注释	strstr
谁是迈克尔·乔丹的儿子	迈克尔·乔丹
林正英本名么	林正英
周星驰老家	周星驰
计算几下ds的耗油量	ds
当归的生物种类	当归
希尔瓦娜斯·风行者的姐姐叫什么名字	希尔瓦娜斯·风行者
无题的文学体裁	无题
谁与三毛在一起了	毛在
中国知网的官网	中国知网
朴槿惠结婚了	朴槿惠
薛之谦是哪所学校的校友	薛之谦
126的简称	126
黎明生机的混音	黎明生机
消防宣传日都干啥	消防宣传日
四分位数的例子有哪些	四分位数
借记卡的使用方法	借记卡
釜山行用外语怎么说	釜山行
春节一般都干什么	春节
四个全面由谁提出的	四个全面
区块链的特征	区块链
你曾是少年的专辑类型	少年
往香港打电话前拨什么号	打电话
维生素a看上去什么样	维生素a
秋田犬的原产地是哪里	秋田犬
当时以什么为指导思想进行的文艺复兴	文艺复兴
在哪能看到走向共和	共和
英国所在的洲在哪里	英国
陈奕迅的管理人是	陈奕迅
柏拉图是谁的弟子	柏拉图
加利福尼亚州的有名景点	加利福尼亚州
文明5在哪里玩	文明5
草榴社区被创立于什么时候	草榴社区
第一次发行人民日报是什么时候	人民日报
centos使用要钱不	centos
你曾是少年的专辑是哪种类别	少年
lemontree的演唱者	lemontree
中国旅游的主要景点有哪些	中国旅游
鸡蛋果是什么属的	鸡蛋果
scratch性质	scratch
啥叫t恤衫	t恤衫
天宫一号的长度是多少	天宫一号
能算出月球的离心率	月球
请回答1988有多少集	请回答1988
孙悟空是个啥来头	孙悟空
网页汉语拼音的书写	网页
釜山行用英语怎么说	釜山行
中国地质大学的邮编是多少	中国地质大学
澳大利亚最著名的城市是哪些	澳大利亚
蜂蜜有哪些营养成份	蜂蜜
皇后大道东的曲目数量	皇后大道东
李嘉诚的媳妇	李嘉诚
大家都称李昌钰为什么	李昌钰
mfc一般适合什么人使用	mfc
哪些地方有拉布拉多猎犬	拉布拉多猎犬
李嘉诚的老婆叫什么	李嘉诚
曹操的封号是什么	曹操
拉斯维加斯具体建成的时间	拉斯维加斯
苏轼在什么时候与世长辞的	苏轼
走向共和都发行到哪里	走向共和
在哪可以找到bose公司	bose
金木研的生日么	金木研
ig老板是谁	ig
组策略应用于什么领域	组策略
新干线的解释	新干线
咱们相爱吧的制造时间	相爱
中山的名花	中山
美人鱼叫什么	美人鱼
文艺复兴时期宣扬的指导思想究竟是什么	文艺复兴
unity3d由谁研究出来的	unity3d
崔健的厂牌是什么	崔健
services.msc的存在系统	services.msc
拉希奥身处在哪儿	拉希奥
什么样的工作是研究员干的	研究员
怎么称呼宋仲基的粉丝	宋仲基
华盛顿哥伦比亚特区有什么机场么	华盛顿哥伦比亚特区
哪里有幻灯片版式	幻灯片
路德维希·凡·贝多芬去世时多大	路德维希·凡·贝多芬
林允的经纪公司	林允
解释下fyi	fyi
大熊猫还能怎么说	大熊猫
刘邦什么时候死的	刘邦
董力代表什么队出战	董力
静电的优势	静电
宋仲基的粉丝们叫啥	宋仲基
你曾是少年的专辑类别	少年
马云的具体成就有哪些	马云
李嘉诚的爱人是谁	李嘉诚
哪个英文缩写代表雅思	雅思
杀生丸的爱人是怎样的	杀生丸
ncbi哪个国家研发的	ncbi
扭矩的数值	扭矩
哪些场地是用来打羽毛球的	羽毛球
崔健的音乐厂牌是什么	崔健
说几个玛丽苏的近义词	玛丽苏
唯品会都有什么语	唯品会
127.0.0.1的作用	127.0.0.1
老友记的主题曲歌名	老友记
任天堂邮编代码是多少	任天堂
开化大酒店的层数是	开化大酒店
社会保险能带来什么	社会保险
问号用在什么地方是正确的	问号
冰菓的出品人	冰菓
斯卡哈的学生叫什么	斯卡哈
朝鲜哪些钱能用	朝鲜
什么作品让庄子名垂千古	名垂千古
安徽哪儿最好玩儿	安徽
怎么下载游戏避难所	避难所
加拿大的国庆节在几月几号	加拿大
谁是惠普老板	惠普
治疗乳腺结节的方法	乳腺结节
问号主要应用于什么样的句式	问号
中二病的反义词是什么	中二病
蓝染惣右介的花语有什么特别的意思	蓝染惣右介
springmvc是如何应用的	springmvc
荷兰国家代码信息	荷兰
卢旺达种族大屠杀的死伤人数究竟达到了多少人	卢旺达种族大屠杀
狗带的意思	的意
巴霍巴利王电影成本多少钱	巴利
玉皇大帝居所	玉皇大帝
seo的发明时间	seo
电影巴霍巴利王制作成本需要多少	巴利
湿度属于什么专业的	湿度
拉斯维加斯是哪个时间建立的	拉斯维加斯
人字的四角号码分别是多少	少
内容分发网络的基础有哪些	内容分发网络
在多少海拔种葡萄比较合适	葡萄
巴洛克音乐流行年代	巴洛克音乐
上海迪士尼乐园的气候类型	上海迪士尼乐园
怎么使用自然常数公式	自然常数
地球的质量	地球
人民日报创刊时间	人民日报
林允的经济公司是哪个	林允
h.264	h.264
自传是谁的	自传
民国四大美男指哪些人	民国四大美男
极限挑战现在有没有播完	极限挑战
哪个导演拍的芈月传	芈月传
我的奇妙男友的编剧	男友
跟罗敏庄在一起的那个人叫什么	罗敏庄
澳大利亚最好的是哪些国家	澳大利亚
极乐净土的罗马音	极乐净土
海词是什么	海词
国家学生体质健康标准的主导思想	国家学生体质健康标准
重庆市南岸区天台岗小学有着什么样的校训	天台岗小学
microusb的特点	microusb
每小时高铁能跑的路程	小时
python何时被发行出来的	python
蜂蜜含有哪些成分	蜂蜜
在哪个网站能看到灵能百分百的连载	灵能百分百
历史怎么说阴丽华的	阴丽华
欧洲的原始意义	欧洲
喝拿铁对人有什么危害	拿铁
机械键盘有什么优势	机械键盘
碳酸氢钠每立方厘米多少克	碳酸氢钠
英国的首相	英国
岳云鹏一般都和谁搭档	岳云鹏
陈奕迅经纪人是谁	陈奕迅
乔任梁的星座么	乔任梁
爱新觉罗·溥仪的字号	爱新觉罗·溥仪
谁教的苏秦	苏秦
老炮儿赚了多少门票钱	老炮儿
马赛曲的其他叫法	马赛曲
长白山脉的主山	长白山脉
许巍日常喜欢什么	许巍
得了乳腺结节用什么治疗	乳腺结节
洛杉矶火车站是哪些	洛杉矶
windows.old在哪儿	windows.old
雪鹰领主的主人公叫什么	领主
贝加尔湖的深度大概是多少米	贝加尔湖
哪天是圣诞节	圣诞节
哪句是1号店内部标语	哪句是1号
西伯利亚雪橇犬属于是什么族群	西伯利亚雪橇犬
芈月传的导演是谁	芈月传
张艺兴的团队名称	张艺兴
全民超神的下载网站	超神
火龙果的生物划分在哪个目里	火龙果
火影忍者是哪个国家的	火影忍者
村上春树的所在城市	村上春树
雅思英文名字缩写	雅思
曹操的谥号	曹操
演员的英文怎么念	演员
让庄子出名的是哪个作品	庄子
从你的全世界路过的片长	从你的全世界路过
雅思的英文简写	雅思
一人我饮酒醉从开始到结束需要多久	人我
赵云生活在哪个时期	赵云生
社会保险想要解决什么问题	社会保险
什么叫恶魔雪茄	恶魔雪茄
qq啥时候更的新	qq
资本代表什么	资本
许巍享受于去做什么	许巍
缘之空的代理发行	缘之空
有哪些拉面的制作方法	有哪些拉面的制作方法
李嘉诚的妻子是谁	李嘉诚
谁扮演过猪八戒这个角色	猪八戒
非洲的原本含义	非洲
新西兰的通用货币是什么	新西兰
拥有歼-20的是哪个国家	歼-20
如果蜗牛有爱情的国际标准书号	如果蜗牛有爱情
绝命毒师被冠以什么奖项	绝命毒师
文艺复兴的指导思想	文艺复兴
x射线的特征	x射线
windows10的发行商	windows10
孙悟空的来头	孙悟空
无翼鸟能飞多少公里每小时	无翼鸟
云盘的基础理论	云盘
哪个银行是蒙古国的中央银行	蒙古国
固态硬盘是由什么组合而成的	固态硬盘
树莓派的简单代名词是什么	树莓派
大数据是谁取的名	大数据
多少的地是纽约中央公园所拥有的	纽约中央公园
酉阳杂俎的朝代	酉阳杂俎
王维毕生的心血	毕生
张艺兴在内的那个组合叫什么名字	张艺兴
太岁的成分有什么	太岁
双曲线离心率怎么算	双曲线
内科有什么好的医治手段	内科
王思聪他爹是谁么	王思聪
哪个人是snh48的最高执行长	snh48
git的音标	git
吃茯苓会不会中毒	茯苓
咖喱的口味	咖喱
kenarai音乐作品资料	kenarai
克里斯汀·斯图尔特的基因是什么	克里斯汀·斯图尔特
路西法从哪来	路西法
粉丝喜欢叫刘亦菲什么	刘亦菲
翻译一下s.t.	s.t.
张若昀经典音乐作品有哪些	张若昀
事实上李白本人叫什么	李白
人字的四角号码分别是多少	少
神奇动物在哪里作者是谁	神奇动物
岳云鹏一般和谁搭档的最多	岳云鹏
碳酸氢钠一立方厘米的克数	碳酸氢钠
谁是神印王座的创作者	神印王座
网易公司股票上市号码是多少	网易公司
什么地方是朱棣去世的地方	朱棣
什么名字是诗经的	诗经
旧金山的人们用的是哪种时区	旧金山
澳门人口数量	澳门
192.168.1.1的分类	192.168.1.1
黄致列哪些歌好听	些
长城的位置	长城
cp的来源是什么	cp
研究员平时做什么	研究员
商标注册的作用	商标注册
谁给木心当过徒弟	木心
youtube大概有多少员工	youtube
什么温度下维生素c会转变状态	维生素c
王家卫的家人有谁	王家卫
芒果汁怎么做的	芒果汁
websocket指的是什么	websocket
菲德尔·卡斯特罗的生日	菲德尔·卡斯特罗
紫霞仙子的姐姐是谁么	紫霞仙子
羊肉什么味儿	羊肉
菲德尔·卡斯特罗生于哪年	菲德尔·卡斯特罗
张继科都获得了什么奖	张继科
如何表示胰岛素的分子式	胰岛素
哆啦a梦连载于	哆啦a梦
希拉里·黛安·罗德姆·克林顿的求学经历	希拉里·黛安·罗德姆·克林顿
几月几号是圣诞节	月
sumif函数的定义是什么	sumif函数
哪些车牌代码是青岛的意思	青岛
大数据提出者	大数据
弹丸论破3-theendof希望之峰学园由哪位代理发行	theend
vlookup函数	vlookup函数
斗罗大陆第一版是什么时候印制的	斗罗大陆
秦始皇享年多少岁	秦始皇
facebook的类别	facebook
择天记首个发布的网是什么网站	择天记
葡萄在多少海拔内能存活	葡萄
名侦探柯南：纯黑的恶梦的上映时间	名侦探柯南
58同城的品牌定位	58同城
爸爸去哪儿第四季的主持人叫什么	爸爸去哪儿第四季
太岁是由什么组成的	太岁
惠普的董事长是谁	惠普
消防宣传日一般有什么环节	消防宣传日
通过什么进行的职称评审	职称评审
荷塘月色的创作时间是多会儿	荷塘月色
路德维希·凡·贝多芬享年多少	路德维希·凡·贝多芬
颐和园开放时间	颐和园
赵云	赵云
哪年雪中悍刀行首发	雪中悍刀行
谁被自来也喜欢	自来也
甘肃的特色产品有哪些	甘肃
锡克教流传地方	锡克教
des的体系	des
熊猫tv还叫什么	熊猫
乳腺结节治疗的方法	乳腺结节
瓜德尔港坐落在什么地方	瓜德尔
老司机带带我的原唱	老司机带带我
聚乙烯能达到最高的沸点是多少	聚乙烯
是谁把林中鸟作出来的	林中
银魂的出版的具体时间段是什么时候	银魂
刘贺的陵墓叫什么	刘贺
朴槿惠的婚姻状态怎么样	朴槿惠
邓紫棋喜欢吃什么东西	邓紫棋
许巍都爱干什么	许巍
简单说下fscanf是什么	fscanf
金牛座是几月几号	金牛座
星座是如何提出的	星座
太岁的成分	太岁
比亚迪唐的首发日期	比亚迪唐
是谁想到了四个全面的	四个全面
联想集团是哪个国家的公司	联想集团
哪些地方能下载辐射避难所	避难所
哪个公司出钱做的微微一笑很倾城	微微一笑很倾城
什么叫动漫	动漫
歌诗达邮轮是一种具有什么画面感的品牌	歌诗达邮轮
runtimeerror的表现	runtimeerror
朴槿惠的婚姻生活	朴槿惠
林俊杰信奉什么宗教的	林俊杰
姜思达毕业于哪个学校	姜思
什么样的情况引发高血压	高血压
火影忍者是哪个地方的故事	火影忍者
纽约中央公园多大	纽约中央公园
卢旺达种族大屠杀的伤亡人数是多少	卢旺达种族大屠杀
谁做出来的熊猫烧香	熊猫烧香
瓜德尔港是哪的景点	瓜德尔
舒淇的性格	舒淇
挂历是怎么来的	挂历
老友记主题曲好听吗?叫什么名字	老友记
acfun的网站口号是怎么说的	acfun
冬至存在于什么季节中	冬至
摩洛哥有多少人	摩洛哥
vivo是什么公司的	vivo
163是哪种形式	163
哪种流派是赵雷的	赵雷
什么时候第一次发行的斗罗大陆	斗罗大陆
上海虹桥站算是什么级别的车站	上海虹桥站
秋田犬的产地是哪	秋田犬
沙溢老婆是谁	沙溢
matlab的英文全称怎么拼	matlab
秦时明月之君临天下的其他名称怎么叫	秦时明月之君临天下
谁跟赵一荻在一起了	在一起
那些花儿的其他演唱者	那些花儿
怎么做汤圆好吃	汤圆
核工业404的具体位置在哪儿	核工业
mindgeek是哪个公司研发的	geek
李未央妹妹	李未央
sleep函数的使用方式有哪些	sleep函数
搜狗哪个公司旗下的	搜狗
杨绛的女儿是谁	杨绛
迪拜多大么	迪拜
同样都念过麻省理工学院的名人都有谁	麻省理工学院
话说中国历史朝代的政治体制是什么	话说中国历史
罗永浩哪天出生的	罗永浩
择天记的首发网站是什么网	择天记
1的中国发音	1
五官的首要含义为何	五官
什么歌是德国国歌	德国
北京南站归哪个部门管	北京南站
全国青少年网络文明公约是什么时候提出的	青少年
汉江有多大流域面积	汉江
芈月传谁拍的	芈月传
谁是最后的问候的作词者和作曲者	最后的问候
www为何被叫做www	www
张国焘去世的地方是在哪儿	张国焘
谁是长白山脉的主峰	长白山脉
英雄联盟的游戏类型是什么	英雄联盟
谁是徐志摩前妻	徐志摩
陈奕迅用谁当经纪人	陈奕迅
在哪把神舟十一号飞船发射出去的	神舟十一号飞船
说几个长沙的高校名字	长沙
火龙果属于哪个目	火龙果
斗罗大陆的第一版什么时候发行的	斗罗大陆
因什么作品让人熟知庄子的	因什么作品让人熟知庄子
酉阳杂俎诞生于哪个朝代	酉阳杂俎
幻灯片版式处于哪里	幻灯片
鸡蛋果的生物分类	鸡蛋果
i在拉丁文字母里面排哪个位置	i
谁提出的大数据	大数据
哪年创办的台湾电影金马奖	台湾电影金马奖
maven的本质	maven
红茶的生物目属	红茶
摩尔斯电码是哪位做出来的	摩尔斯电码
无锡的火车站分别是什么	无锡
云画的月光在哪国拍的	云画
奔驰的主要产品	奔驰
香港的电话区号是几位	香港
陶瓷最初的原料是哪种东西	陶瓷
赵云出生在哪个朝代	赵云
麻生希的兴趣	麻生希
陶瓷中包含什么物质	陶瓷
谁跟甄嬛在一起了	在一起
latex是什么属性	latex
谁是cortana的原始模型	cortana
杜鹃会的技能有哪些	杜鹃
张起灵的祖父	张起灵
张继科揽下哪些奖项	张继科
说几个英文名的例子	例
后来的原曲叫什么	后来
苏轼什么时候仙逝的	苏轼
固态硬盘的是由哪些部件组合的	固态硬盘
路西法的出处	路西法
神奇女侠的爸爸是哪个	神奇女侠
黄山的景区级别	黄山
步步惊心：丽还叫什么	步步惊心
1号店用的什么口号	1号店
we角逐哪些赛事	we
李未央妹妹的名字是	李未央
voc容易导致人有哪些不良反应	voc
农业电子商务现在什么状态	电子商务
中东信仰的宗教是哪个教	中东
qq邮箱的英文	qq邮箱
琅琊榜是哪年的	琅琊榜
谁把金瓶梅发出来的	金瓶梅
华盛顿哥伦比亚特区有哪些机场	华盛顿哥伦比亚特区
中国知网的网址不	中国知网
比利时代表花有哪些	比利时
澳门人口是多少	澳门
9·11事件的事发地点	9·11事件
话说瑜伽日在什么时候	话说
固态硬盘的组成部分有哪些	固态硬盘
东京食尸鬼原始的名字	东京食尸鬼
阿衰喜欢什么	阿衰
奇门遁甲号称什么	奇门遁甲
自传是谁的专辑	自传
贞操带从什么时候开始流传	贞操带
中东哪个宗教人数最多	中东
什么作品可以代表庄子	庄子
广州国际灯光节需要花钱	广州国际灯光节
周杰伦的民族	周杰伦
尊重的意思	尊重
正态分布是谁的发现	正态分布
是什么时候把docker发行出来的	docker
王牌逗王牌的对白是什么语种	王牌
互联网有哪些定义	互联网
谁教的张宇	张宇
是什么思想指导了文艺复兴运动的	文艺复兴
拙政园有多少地	拙政园
dpi指什么	dpi
扭矩的数值	扭矩
docker的发行日期	docker
阿里巴巴集团的地址	阿里巴巴集团
如何用英语说性格	英语说
李小龙子女叫什么	李小龙
文明5在哪个平台玩	文明5
百度百科是哪个公司旗下的	百度百科
阿里巴巴集团总部地点	阿里巴巴集团
撒旦的图腾是什么	撒旦
seo的诞生时间	seo
刘邦的离世时间是	刘邦
美国大选举办地在什么位置	美国
梁海玲全名叫什么	梁海玲
去什么院系能学到会计	去什么院系能学到会计
timbaland的唱片公司是哪家	timbaland
提出拓扑学的人是谁	拓扑学
开始建设天安门的时间是多少	天安门
朋克起源时期	朋克
欧洲原本指什么	欧洲
亮剑的颜色	亮剑
张国荣跨越97演唱会的唱片发行商是哪一家公司	张国荣跨越97演唱会
什么样的心理健康状态是好的	态
苹果的ceo	苹果
加拿大的国庆节是什么时候开始过的	国庆节
什么电影叫立体电影	立体电影
造成表面粗糙度的原因	表面粗糙度
引号代表什么	引号
老司机带带我的原唱	老司机带带我
中国梦的含义是什么	中国梦
沈腾的姐姐	沈腾
我需要广州的邮编	广州
李易峰的粉丝名	李易峰
老友记选了哪首歌当主题曲	老友记
英文简历的模板	英文简历
名侦探柯南演到哪集了	名侦探柯南
李飞飞在哪里干什么	李飞
天气的涵义	天气
欧洲的原始意义	欧洲
谍影重重分级	谍影重重
提起写字板通常还代表什么	写字板
windows.old的位置	windows.old
怎么理解尊重	理解
硫化氢的毒性高低	硫化氢
天安门从哪年开始建设的	天安门
为什么会产生国有企业改革	国有企业改革
bigbang是谁	bigbang
元旦的设立时间	元旦
薛之谦的母校	薛之谦
火影忍者剧场版谁画的	火影忍者剧场版
选举人票的成因	选举人票
什么花象征着比利时	比利时
歌剧魅影的作词	歌剧魅影
什么年代有的朋克	朋克
巴洛克音乐什么时间流行	巴洛克音乐
谁是苏联的国家领袖	苏联
张家界的机场	张家界
沙溢在哪儿出生的	沙溢
什么分级是谍影重重的	谍影重重
双子座的象征都有哪些	双子座
那个发射了神舟十一号飞船的地方叫什么	神舟十一号飞船
arduino的创办人叫什么	arduino
迈克尔·乔丹的孩子	迈克尔·乔丹
在哪里举办亚洲足球锦标赛	亚洲足球
lorde的歌曲曲风	lorde
巴厘岛说什么话	巴厘岛
奚梦瑶爱干的事有哪些？说一下奚梦瑶的喜好吧	奚梦瑶
什么等级是色情片	色情片
电磁波的坏处是啥	电磁波
内科的医疗方法	内科
沙溢的媳妇是谁	沙溢
伊万卡·特朗普的老公叫什么	伊万卡·特朗普
崔健的厂牌是哪家	崔健
表面粗糙度的成因	表面粗糙度
酉阳杂俎写于哪个朝代	酉阳杂俎
非洲的原本含义是什么	非洲
柳岩迷哪种动物	柳岩
天安门第一块砖是什么时候垒上去的	天安门
教我怎么读xamarin	xamarin
周星驰的籍贯	周星驰
高铁有多快	铁
那场卢旺达种族大屠杀总共有多少人受害	卢旺达种族大屠杀
为何要改革开放	改革开放
上海虹桥站的火车站级别	上海虹桥站
威风堂堂由谁谱曲的	威风堂堂
演员的英语是什么	演员
极限挑战播出状态是什么	极限挑战
核心期刊有什么值得参考的理论	核心期刊
平凡的世界出版年份	平凡的世界
汤圆的做法有哪些	汤圆
从你的全世界路过有多长	从你的全世界路过
哪儿是慈禧的陵墓	慈禧
直男癌这个词语是怎么出来	直男癌
巴洛克是什么时代流行	巴洛克
麻生希做哪些事情会很开心	麻生希
写出欢乐颂曲子的人是谁	欢乐颂
如何标准的用编号表示如果蜗牛有爱情	如果蜗牛有爱情
南京地铁3号线哪天正式面向我们的	南京地铁3号线
谁掌管了snh48	snh48
中国式关系在哪个播放软件看	中国式关系
白素贞妹妹的全名	白素贞
冰与火之歌的翻译者	冰与火之歌
秦时明月之君临天下的中文名字是什么	秦时明月之君临天下
hyper-v的研发公司	hyper-v
windows.old的位置	windows.old
美丽新世界源自哪里	美丽新世界
台湾电影金马奖什么时候诞生的	台湾电影金马奖
爱奇艺的英文名	爱奇艺
cp的来源是什么	cp
1号店的公司口号	1号店
玉皇大帝的住所是哪儿	玉皇大帝
纳兰性德的字号	纳兰性德
大概多少是金毛寻回犬的高度	寻回犬
范冰冰的血型	范冰冰
英语i在拉丁字母表里的排序	英语
谁在从零开始的异世界生活配过音	从零开始
贝拉克·奥巴马妻子资料	贝拉克·奥巴马
张宇恩师名字是	张宇
比热容是什么单位	比热容
广州国际灯光节的门票是免费的	广州国际灯光节
timbaland签约哪个唱片公司	timbaland
爱奇艺的英文名么	爱奇艺
东南亚国家联盟到底有多大	东南亚国家联盟
怎么样才能融资	才能
孤独英语怎么说	独英
内容分发网络有什么基础	内容分发网络
给国王与乞丐录音的是谁	王与
魔幻车神的发行商是谁	车神
什么名称也代表转义字符	转义字符
硫化氢毒性低不低	硫化氢
滇西科技师范学院的校训是什么	学院
莫文蔚的偶像是谁	莫文蔚
你懂谷歌学术的作用	谷歌
丁墨在哪里	丁墨
4399小游戏的总部地址是	4399小游戏
转义字符又被叫做	转义字符
公主头存在于哪类形象中	公主头
伊万卡·特朗普的爱人	伊万卡·特朗普
我们在什么时候看到的斗罗大陆	斗罗大陆
猫属于什么纲	猫
饕餮原本的意思是	饕餮
电影最初是在哪里产生的	电影
神司马懿有哪些技能	神司马懿
ebsco在什么地方	ebsco
神司马懿的技能都有哪些	神司马懿
一般都什么地方能打羽毛球	羽毛球
新三板的起始时间	新三板
swot分析法又叫什么	swot分析法
电脑是哪年有的	脑
上古卷轴5是由谁策划出来的	上古卷轴5
紫霞仙子姐姐的名字	紫霞仙子
自来也喜欢的人	自来也
如果蜗牛有爱情的国际代码	如果蜗牛有爱情
英文名的示例	英文名
辛普森杀妻案人物	辛普森杀妻案
刘邦的具体去世时间	刘邦
可行性研究报告的标准是什么	可行性研究报告
闪电侠有哪些能力	闪电侠
长征五号系列运载火箭是哪个国家的专利	长征五号系列运载火箭
如果蜗牛有爱情的国际编号是什么	如果蜗牛有爱情
塞卡病毒的常见病因有哪些	病毒
唐纳德·特朗普的昵称	唐纳德·特朗普
金瓶梅是哪家公司刊行的	金瓶梅
你曾是少年的专辑类型是什么	少年
希尔薇到现在有多大了	希尔
宇宙直径不	宇宙
田馥甄的粉丝都自称什么	田馥甄
荷塘月色是作者哪个时间段创作出来的	荷塘月色
要花多少钱可以买锦绣未央	锦绣未央
参商是谁唱的	参商
计算月球的离心率	月球
中国平安保险董事长	平安保险
萨尔的坐骑是什么	萨尔
朴槿惠有没有结过婚	朴槿惠
比亚迪股份有限公司具体有多大的地盘	比亚迪股份有限公司
那句话是1号店用来励志的口号	那句话
哪个人把威风堂堂的曲子编出来的	威风堂堂
中央电视台的领域范围	中央电视台
秦时明月之君临天下有什么其他的命名	秦时明月之君临天下
中国知网的官网是什么	中国知网
重庆是中国哪个地区	重庆
五四运动有哪些影响	五四运动
哪些参与了鲁荣渔2682号惨案	268
太岁	太岁
中国国家女子排球队的外文队名	中国国家女子排球队
加利福尼亚大学伯克利分校的校歌是哪首	加利福尼亚大学伯克利分校
哪个地方有中南海	中南海
博柏利品牌的定位	博柏利
风信子有哪些花语	风信子
建造歼-20的是哪个国家	歼-20
英雄联盟的游戏类型是什么	英雄联盟
foxmail的名字	foxmail
半月板会因为什么而生病	半月板
草榴社区什么时候与我们初次见面的	草榴社区
亚洲的叫法还有什么	亚洲
梦田的合声	梦田
英制螺纹有几种直径	英制螺纹
娶妻当如阴丽华的典故是什么	阴丽华
陶瓷的原料是什么	陶瓷
王家卫的家庭成员都有谁	王家卫
新陈代谢的首要含义	新陈代谢
谁写的跳蚤之歌的	跳蚤之歌
东京的人口	东京
赵一荻与谁是夫妻	赵一荻
复旦大学的地址	复旦大学
上海虹桥站的车站等级	上海虹桥站
加拿大的语言是什么类的	加拿大
管理学代表人物的具体名字	管理学
谍影重重是什么等级的	谍影重重
runtimeerror大致上都会怎么样	runtimeerror
平时都几个人一起玩生死狙击	生死狙击
哪些系统里有services.msc	services.msc
qq空间版本	qq空间
58同城用哪句话作为自己的品牌定位	58同城
唱上瘾的是哪位	上瘾
hao123附属于哪家公司	hao123
在线翻译哪些工具比较方便	在线翻译
王维最用心的作品是哪些	王维
重庆市南岸区天台岗小学校训是哪句话	天台岗小学
拉希奥身处哪里	拉希奥
章鱼哥的朋友是怎样的	章鱼哥
火影忍者：漩涡博人传的主题曲是哪一首歌	火影忍者
九州·天空城的主演	天空城
microsoftvisualstudio的更新时间是	microsoftvisualstudio
重定向该如何操作	重定向
好好奇走向共和都在哪进行了发行	走向共和
小米note怎么卖	小米note
林丹的运动项目	林丹
生物学家把猫分在哪里啦	生物学家
斗罗大陆的出版时间	斗罗大陆
重庆市南岸区天台岗小学的校训吧	天台岗小学
可乐的害处	可乐
浙江大学在哪儿	浙江大学
哪年首发的雪中悍刀行	雪中悍刀行
谁是模特的作词	模特
珠穆朗玛峰的门票怎么卖的	珠穆朗玛峰
歌剧魅影的作词人	歌剧魅影
猫咪老师是什么变化来的	猫咪老师
唐纳德·特朗普的信仰是什么	唐纳德·特朗普
1号店都用什么口号给员工打气	1号店
犬儒主义本来的意思是什么	犬儒主义
jquery的最新版本	jquery
cvt是通过什么原理运行的	cvt
pdca循环指什么	pdca循环
地球的重量是多少	地球
刺客信条：大革命的主角是谁	刺客信条：大革命
比热容的单位是什么	比热容
哪位鼓手在黑豹乐队	位
flowerdance所属专辑	flowerdance
怎么定义股票型基金	股票型基金
秦始皇多少岁离世的	秦始皇
林中鸟是谁的作品	林中
洋葱的食用方法都有哪些	洋葱
thebeatles的音乐类型	thebeatles
这担仔面里面都有什么	担仔面
松花江的流域有多大	松花江
民族乐派是什么时候的	民族乐派
facebook属于哪类公司	facebook
好妹妹乐队唱什么样的歌	好妹妹乐队
mac地址的释义	mac地址
恶魔雪茄是啥	恶魔雪茄
周杰伦的民族是哪个	周杰伦
不为谁而作的歌的音乐风格	歌
加利福尼亚大学伯克利分校的校歌的歌名叫什么	加利福尼亚大学伯克利分校
查查铁观音的门类划分	铁观音
麻雀属于哪个种的	麻雀
怎么称呼苏小妹爸爸	苏小妹
龚琳娜的另一半	龚琳娜
激光镭雕机是怎么做出来的	激光镭雕机
是谁给洛天依配音的	洛天依
爱新觉罗·玄烨的年号是什么	爱新觉罗·玄烨
贝加尔湖的水的高度是多少	贝加尔湖
塞浦路斯用英语怎么说	塞浦路斯
海词都能干嘛使	海词
cortana是怎么来的	cortana
四大天王由谁组成的	四大天王
步步惊心：丽的其他译名	步步惊心
用什么名字可以代替诗经	用什么名字可以代替诗经
尹恩惠的学位是什么	尹恩惠
你有ysl官网么	ysl
计算扭矩数值的方法	扭矩
淘宝网成立在哪一年	淘宝网
九州·天空城的主演	天空城
草榴社区的成立时间	草榴社区
小米note多少钱	小米note
土星5号运载火箭从底部到顶部有多高	土星5号运载火箭
弹丸论破3-theendof希望之峰学园是谁代理发行的	theend
杀生丸爱人	杀生丸
大鱼海棠生产成本	海棠
什么时候出生的人是金牛座	金牛座
美国队长3电影成本是多少	美国队长3
普通的不锈钢是什么材料	普通
哪个城市的迪士尼是总部	迪士尼
中国共产党中央纪律检查委员会是管什么的	中国共产党中央纪律检查委员会
龚琳娜的配偶	龚琳娜
大麦茶的功效有什么	大麦茶
林丹做的运动叫什么	林丹
ig被谁所拥有	ig
你是通过什么队知道的董力	董力
天龙八部总制片人是谁	天龙八部
绝世唐门是关于什么的书	绝世唐门
贵金属怎么做	贵金属
ncbi所属国家	ncbi
李昌钰被人称为什么	李昌钰
富士康谁创立的	富士康
卢旺达种族大屠杀的伤亡人数	卢旺达种族大屠杀
哪儿是华东师范大学	华东师范大学
黑羽的外文是什么	黑羽
谁是老司机带带我的原唱	老司机带带我
阴茎是谁特有的	阴茎
hao123的所属公司	hao123
关于美丽的神话音乐版权	美丽的神话
周深偶像是谁	周深
雪中悍刀行首发日子	雪中悍刀行
美国所在的大洲	美国
姜思达在哪个学校上过学	姜思
sumif函数的表达式怎么写	sumif函数
58同城的品牌定位	58同城
贝拉克·奥巴马的妻子	贝拉克·奥巴马
迪士尼的总部设在哪了	迪士尼
windowspowershell的平台是通过什么运行的	windowspowershell
192.168.1.1属于什么分类	192.168.1.1
宋仲基的粉丝名称	宋仲基
lachata专辑都有哪些歌	lachata
中国历史朝代的政治体制是什么	中国历史朝代
谁是南通的名人	南通
武动乾坤中谁最关键	武动乾坤
机器学习涉及的学科	机器学习
五位一体来源于哪	五位一体
ac米兰足球俱乐部的队歌	ac米兰足球俱乐部
谁是苏小妹的父亲	苏小妹
www具体是什么	www
美丽的春天歌手	美丽的春天
邓紫棋爱吃的食物是什么	邓紫棋
那个古代的梅兰芳的民族族群是什么	梅兰芳
灰姑娘与四骑士的语言	四骑士
灵魂摆渡3什么软件可以看	灵魂摆渡
景甜毕业于哪	景甜
如何运用springmvc	springmvc
挂历是怎么来的	挂历
歌诗达邮轮的品牌调性	歌诗达邮轮
秋田犬的产地吧	秋田犬
核心期刊来自哪一理论	核心期刊
四糸乃都喜欢什么	四糸乃
太岁是个什么东西	太岁
迈克尔·乔丹有几个儿子	迈克尔·乔丹
灵能百分百连载于	灵能百分百
圣诞节是哪天	圣诞节
鸡蛋果是哪个属类的	鸡蛋果
简单讲讲fscanf	fscanf
什么是site么	ite
i的起源是什么	i
一加手机的大小是多少	一加手机
t-ara的出道时间	t-ara
nba正式与我们见面是哪天	nba
唐纳德·特朗普的别称	唐纳德·特朗普
赵敏都由谁出演过	赵敏
windowspowershell的平台是什么	windowspowershell
三七粉的优点	三七粉
svchost.exe的服务商	svchost.exe
猫咪老师源于什么	猫咪老师
梅兰芳的民族是什么族群的	梅兰芳
1024是什么节日	1024
sktelecomt1的英文名称	elecom
php的设计师到底是谁	php
什么东西可以表现撒旦	撒旦
乌台诗案的历史时期	乌台诗案
刘慈欣当的是个什么	刘慈欣
3d打印是谁发明的	3d
microsoftoffice的最新版	microsoftoffice
悦的拼音是什么	悦
戚继光有什么故事	戚继光
汉江的流域面积	汉江
松花江的流域面积	松花江
张学良生于什么地方	张学良
ascii表示什么	ascii
釜山行的外语么	釜山行
生死狙击都能组几人的队伍玩	生死狙击
www中的w是什么意思	www
唱你曾这样问过的是谁	曾
核心期刊有什么理论依据	核心期刊
二战发生在哪儿	战
方大同的唱歌特点是什么	方大同
不锈钢的结构成分是什么	不锈钢
欧洲原本指什么意思	欧洲
是谁出品了3d肉蒲团之极乐宝鉴这部片子	3d肉蒲团之极乐宝鉴
塞浦路斯的英文怎么写	塞浦路斯
怎么解释scratch	scratch
爱新觉罗·溥仪的字号叫什么	爱新觉罗·溥仪
项羽到底是什么族的人	项羽
王鸥学什么的	王鸥
王嘉尔的家人有谁	王嘉尔
操作系统由什么构成的	操作系统
城寨英雄由谁策划出来的	英雄
facebook公司的属性	facebook
核工业404地处哪里	核工业
科学的划分幽门螺杆菌是属于哪的	幽门螺杆菌
周星驰的籍贯	周星驰
赵冀龙身高多少，体重多少	赵冀龙
microusb的特征	microusb
在新西兰花什么钱	新西兰
提出全国青少年网络文明公约的是什么时候	青少年
神印王座的漫画作者是谁	神印王座
帝霸进展到哪里了	帝霸
电视剧的拼音是什么	电视剧
谁是辛普森杀妻案里面的人	辛普森杀妻案
sat的其他解释	sat
秘鲁时区	秘鲁
金瓶梅被哪个公司发出的	金瓶梅
海洋的体积有多大	海洋
奇迹暖暖对战平台	奇迹暖暖
雅思的英文简称	雅思
铣床需要以什么为主的运动	铣床需要以什么为主的运动
foxmail的名字是什么	foxmail
新海诚的出生地	新海诚
怎么造成的表面粗糙度	表面粗糙度
象征比利时的是什么花/	比利时
莫文蔚的偶像	莫文蔚
pmo的作用是	pmo
你看你看月亮的脸是哪家公司发行	你看你看月亮的脸
拉面怎么做好吃	拉面
中国知网的地址是什么	中国知网
华盛顿哥伦比亚特区都有什么机场	华盛顿哥伦比亚特区
碳酸氢钠的密度	碳酸氢钠
济州岛都在哪处理行政	济州岛
阿尔伯特·爱因斯坦最著名的理论	阿尔伯特·爱因斯坦
可以在新西兰用什么钱	新西兰
什么时区用在了旧金山	旧金山
逻辑还有没有别的说法	逻辑
三里屯都是在什么时候开放的	三里屯
一加手机的屏幕几英寸	一加手机
重庆北站南广场的车站级别是什么	重庆北站
斯里兰卡的国土面积	斯里兰卡
草榴社区什么时候开始有的	草榴社区
如何理解尊重的含义	尊重
搜狗的主办单位信息	搜狗
给我中国知网的网址	中国知网
pdca循环么	pdca循环
新加坡的英文名	新加坡
rename会出现在哪里	rename
蓝色大海的传说的中文叫法	大海的传说
阿特拉斯的故事	阿特拉斯
中山大学的校训特点是	中山大学
市净率需要如何去算	市净率
seo最早出现的时间	seo
王俊凯的特长	王俊凯
谁是有点儿意思的mv导演	mv
研究员工作内容是什么	工作内容
王思聪是谁的儿子	王思聪
提起什么也会想起转义字符	转义字符
小米手机5是什么系统的	小米手机5
宋智孝的属相	宋智孝
灵蝶是谁	灵蝶
歌诗达邮轮的品牌具有什么气质	歌诗达邮轮
mindgeek属于哪儿	geek
日本首都么	日本首都
1989这部专辑总共播放多长时间	1989
王鸥专业是什么	王鸥
什么时候放的第一期咱们相爱吧	什么时候
端午节吃什么好	端午节
丑八怪所属专辑	丑八怪
中山大学的办学理念是什么	中山大学
百合属于哪种生物类别	百合
哪个是qq空间的版本	qq空间
新海诚跟哪儿出生的	新海诚
西部世界在中国的名字	西部世界
b族维生素的用法用量	b族维生素
ppap翻译成中文名字叫什么	ppap
林俊杰信仰的宗教是哪个教	林俊杰
托福种类有哪些	托福
碳酸氢钠一立方厘米的标准质量是多少	碳酸氢钠
七海千秋的喜好不	七海千秋
李菁学生是	李菁
腾讯老板叫什么名字	老板
需要用什么食材才能做出担仔面	担仔面
圆明园的票价	圆明园
周二珂从事什么行业	行
雍正王朝日常运作策划是谁	雍正王朝
求神司马懿的技能种类	神司马懿
绿罗裙原唱	绿罗裙
唐三的女婿到底是谁	唐三
从你的全世界路过需要放多久	从你的全世界路过
苏轼哪年离世的	苏轼
163邮箱的用途	163邮箱
李相赫的外号是什么	李相
北京南站隶属哪个铁路局管	北京南站
docker发行的日子	docker
如何做拉面	拉面
长沙的大学	长沙
生死狙击的主题内容是什么	生死狙击
树莓派还可以怎么说	树莓派
重庆市南岸区天台岗小学的校训是什么	天台岗小学
天猫原名	天猫
阿特拉斯有哪些故事	阿特拉斯
谁是田雨橙的亲兄弟	田雨橙
dns劫持有什么结果	dns劫持
哪个作曲人给大学问谱的曲	大学问
诗经都有些什么名字	诗经
那个挺漂亮的美女主持人柳岩她喜欢哪种小动物	挺漂亮的美女主持人柳岩
微微一笑很倾城颜色是什么	微微一笑很倾城
给我讲讲黑洞直径	黑洞
熊猫烧香是由谁做出来的额	熊猫烧香
ac米兰足球俱乐部选择了哪首队歌	ac米兰足球俱乐部
什么时候有的全国青少年网络文明公约	青少年
新加坡英文名	新加坡
吉尔伽美什是什么样的人	吉尔伽美什
玉米这首歌是谁唱的	玉米
重定向怎么操作	重定向
滕王阁序是什么体裁的文学	滕王阁序
风信子的花语	风信子
百度百科属于哪个公司	百度百科
江户川柯南的演员名字是	江户川柯南
白茶产地有哪些	白茶
开华大酒店有多少层	大酒店
艾吉奥的后辈都有谁	艾吉奥
金木研的出生年月日	金木研
宁夏有名的重点都大学有哪些	宁夏
t-ara的具体时间是	t-ara
广州的邮政区码是什么	广州
在中国ppap被叫做什么	ppap
苏轼活到了哪年	苏轼
林允的经济公司是什么	林允
大熊猫的别名是啥	大熊猫
拉面的作法有哪些	拉面
汤圆养生有哪些做法	养生
万圣节用英文怎么说	万圣节
谁创作的神奇动物在哪里	神奇动物
京东总部怎么去	京东
金木研的生日	金木研
蒋雯丽的爱人是谁	蒋雯丽
摩尔斯电码发明人是谁	摩尔斯
是谁给蒙奇.d.路飞配的音请问你知道蒙奇.d.路飞的配音演员都有谁吗？好想知道蒙奇.d.路飞的配音演员都有谁	是谁给蒙奇.d.路飞配的音请问你知道蒙奇.d.路飞
比亚迪股份有限公司加起来的面积有多少	比亚迪股份有限公司
王嘉尔的家庭成员	王嘉尔
后来原曲是什么歌	后来
flowerdance出自哪个专辑	flowerdance
论文格式有哪些	论文格式
六味地黄丸的功能	六味地黄丸
岳云鹏一般跟谁在台上搭档演出	岳云鹏
天气是什么意思	天气
一立方厘米的碳酸氢钠有多重	立方厘米
哪个混音师录得走着走着就散了	走着走着就散了
网易公司的股票代码信息	网易公司
荨麻疹容易长在身体哪个部位	荨麻疹
研究员的工作性质是	研究员
灵魂摆渡3电视剧全集在哪可以看	灵魂摆渡
1989的专辑时长多少	1989
谁是杨绛的女儿	杨绛
牙套的优势是什么	牙套
jira被谁生产出的	jira
细胞粒物单位如何表示	细胞
李易峰喊自己的粉丝叫什么	李易峰
威尼斯有什么特产是你最喜欢的	威尼斯
什么简称是ascii	ascii
杜隆坦的好友是哪位	杜隆坦
台湾电影金马奖在哪年被创办的	台湾电影金马奖
国际歌的曲风是什么	国际歌
瑜伽日是几月几号	瑜伽
皇家马德里足球俱乐部的队长到底是谁	皇家马德里足球俱乐部
迪士尼总部	迪士尼
江苏的省会	江苏
张继科赢了哪个奖	张继科
中国好声音第五季在节目里属于哪个分类	中国好声音第五季
江户川柯南的演员	江户川柯南
博柏利留给大家的是什么印象	博柏利
血液透析是用来治疗哪种疾病的	血液透析
ppp怎么分类的	ppp
克里斯汀·斯图尔特是什么基因	克里斯汀·斯图尔特
在什么朝代有的潘金莲	潘金莲
广州国际灯光节的门票是怎样的	广州国际灯光节
w-两个世界什么时候开演的	开演
加拿大的国庆在什么时候	加拿大
万圣节的英语	万圣节
node.js的首发时间是多会儿	node.js
人的四角号码	人
中南海在什么地方	中南海
纽约中央公园建在了多大的地上	纽约中央公园
美人鱼学名	美人鱼
这样爱了版权属于哪家唱片公司	这样爱了
雅思用什么英文字母来代表	雅思
中国历史朝代的政治体制是什么	中国历史朝代
第一本斗罗大陆是什么时候印制出的	斗罗大陆
贞操带的流行时期是什么时候	贞操带
曹操的称号	曹操
公主头都有些什么标签	公主头
网易的股票代码是多少	网易
香港的电话区号不	香港
喜欢你原唱信息	喜欢
我的奇妙男友是由谁写出来的	男友
清明上河图发生在什么时候	清明上河图
谁给做得银翼杀手混音效果	银翼杀手
身体乳这种东西怎么用	身体乳
亚特兰大的高等学府	亚特兰大
互联网的含义有哪些	互联网
唐三的女婿是哪位	唐三
microsoftvisualstudio更新多久了	microsoftvisualstudio
爱新觉罗·溥仪的字号是啥	爱新觉罗·溥仪
姜思达上过的学校	姜思
秘鲁用的是什么时区	秘鲁
兔子饮食是怎样的	兔子
位于张家界的机场叫什么	张家界
这样爱了的版权归属是哪个	这样爱了
德国国歌不	德国国歌
解释一下新陈代谢	解
ppap官方的中文名字是什么	ppap
蓝胭脂的老爸叫什么名字	胭脂
巴黎人信仰的宗教是什么	巴黎人
中东教徒人数最多的宗教是哪个	中东
草榴社区出现于什么时候	草榴社区
沙溢的媳妇是谁么	沙溢
猫咪老师的原型	猫咪老师
董力在哪个运动队的管辖范围内	董力
jenkins是啥	jenkins
老九门其他翻译叫法是什么	老九门
天宫一号有多长	天宫一号
天宫一号的全长	天宫一号
中国新歌声是哪些人主持的	新歌
ip地址有几种类型	ip地址
小米note多少钱	小米note
锦绣未央定价	锦绣未央
木心的弟子	木心
未央宫的建筑面积	未央宫
谷歌学术能干什么	谷歌
w-inds.的主唱叫什么	w-inds.
光波炉号称什么	光波炉
如果买了iphone7我需要操作什么系统	iphone7
qq邮箱的英文名称	qq邮箱
谁是天龙八部总制片人	天龙八部
中秋节什么地区流传	中秋节
拉希奥的地理位置具体在哪儿	拉希奥
网字总笔画数是什么	网
武动乾坤的主要人物	武动乾坤
雅思英文名字的简写	英文名字
张继科赢了哪些奖项	张继科
咱们相爱吧什么时候出品的	相爱
microsoftoffice的最新版什么样	microsoftoffice
董力所属的运动队	董力
相爱穿梭千年采用哪种播出方式	相爱穿梭千年
东京食尸鬼没翻译过来的名字是什么	东京食尸鬼
哪能播放流媒体	流媒体
火影忍者剧场版原作者	火影忍者剧场版
创作了奇妙能力歌词的人	奇妙
杨洋的身高	杨洋
docker发行于何时	docker
4k对齐该怎么办	4k对齐
胰岛素的分子式是什么样的	胰岛素
克里斯汀·斯图尔特的血统	克里斯汀·斯图尔特
苏轼辞世的日子	苏轼
r语言是指什么	r
西部世界的主演么	西部世界
王健林的母亲	王健林
你看不到的天空的词曲	你看不到的天空
顺丰速运成立于哪里	顺丰速运
macd指标另一个名字	macd指标
迪拜的面积	迪拜
谁是李未央的妹妹	李未央
被木心收为徒弟的是谁	木心
台湾电影金马奖的创办时间	台湾电影金马奖
乔任梁啥星座	乔任梁
赵丽颖有哪些昵称	赵丽颖
sleep函数的用法	sleep函数
黄景瑜诞生于什么时候	黄景
方大同的音乐曲风是啥	方大同
latex到底是什么的重要部分	latex
vlookup函数是做什么的	vlookup函数
戚继光有什么典故	戚继光
美元被谁发行出来的	美元
放弃我抓紧我是谁	我是谁
对数是被谁发明的	对数
mybatis以前叫什么	mybatis
金毛寻回犬一般能长多高	寻回犬
长城在中国的什么地方	长城
什么演变成了猫咪老师的形象的	猫咪老师
bangbangbang歌曲语言	bangbang
谁是神奇女侠的爸爸	神奇女侠
谁在维密天使最火	维密天使
3c认证的发布时间	3c认证
侠盗猎车手5是哪部作品的续作	侠盗猎车手5
那个中国好声音第五季是啥节目	中国好声音第五季
哪种能力是白冰所具备的	白冰
金木研的生日是什么时候	金木研
和书信相反的词是什么	书信
互联网有着什么样的意思	互联网
动漫的定义	动漫
dns劫持会发生什么	dns劫持
聚乙烯燃烧的沸点是多少	聚乙烯
哪几个数字是人字的四角号	四角
ig控股人有哪些	ig
谁是城寨英雄的监制	英雄
资产负债表有啥重要性	资产负债表
acfun的广告口号是什么	acfun
microsoftofficeaccess用在哪儿	microsoftofficeaccess
邓紫棋喜欢吃的东西是什么	邓紫棋
联想集团是哪个国家的品牌	联想集团
五位一体在什么样的场合提出的	五位一体
哪些原因导致了国有企业改革	国有企业改革
加拿大人说什么语言	加拿大人
劳尔·卡斯特罗的哥哥是谁	劳尔·卡斯特罗
盂兰盆节是做什么的节日	盂兰盆节
哪天过黑五	五
美人为馅的书名	美人为馅
中国新歌声的主持人是谁	新歌
铳皇无尽的法夫纳的创作者叫什么	铳皇无尽的法夫纳
江户川柯南出演者名字	江户川柯南
必应属于什么	必应
树莓派的英文缩写	树莓派
facebook是什么公司	facebook
鸡蛋果的属类	鸡蛋果
玄奘的弟子都有谁	玄奘
jenkins的归类	jenkins
日本三大妖怪在哪生活	日本三大妖怪
从零开始的异世界生活的配音演员有谁	从零开始
燕麦毒性是什么样的	燕麦
老九门其他译名叫什么	老九门
王维的主要作品	王维
酉阳杂俎所属的朝代	酉阳杂俎
海词有哪些功能	海词
我的奇妙男友创作者是谁	男友
用中文怎么读蓝色大海的传说	大海的传说
ac米兰足球俱乐部唱什么队歌	ac米兰足球俱乐部
哪个是斐波那契数列的表达式	斐波那契数列
琅琊榜的首放时间	琅琊榜
上海迪士尼乐园的气候种类	上海迪士尼乐园
发明摩尔斯电码的人是谁	摩尔斯
163邮箱的作用	163邮箱
三里屯一天开放多长时间	三里屯
澳门的人口数量	澳门
改革开放的含义	改革开放
des的类型有啥	des
劳尔·卡斯特罗的亲哥	劳尔·卡斯特罗
汤圆的家常菜做法有哪些	汤圆
磁力链接的应用范畴	磁力链接
向日葵的风格是什么	向日葵
王心凌找谁当的男朋友	王心凌
长沙有哪些高校	长沙
是什么演变成了挂历的	挂历
中央电视台区域	中央电视台
126的简单背景介绍	126
李嘉诚的夫人叫什么名字	李嘉诚
五证合一的近义词有什么	合一
哪些特产是青海的	青海
王思聪他爸叫什么	王思聪
哪个是纸牌屋的imdb编号	纸牌屋
内科内科的治疗方法是什么	科内
海洋的总体积究竟是多少	海洋
猫在生物学中属于	猫
中国知网的官网	中国知网
最后的问候的作词者和作曲者是谁	最后的问候
圆梦巨人是级别大小	圆梦巨人
邓紫棋喜欢吃什么	邓紫棋
163被划分为什么形式	163
参商哪个歌手唱的	参商
唐纳德·特朗普的别名	唐纳德·特朗普
奇门遁甲被冠以哪些称号	奇门遁甲
mybatis曾用名	mybatis
无题的文体类别	无题
地球的质量	地球
怎样正确下载辐射避难所	避难所
马思纯是不是回族的	马思纯
极限挑战的播出状态是正在播出中	极限挑战
中元节的日期	中元节
网易公司的股票代码	网易公司
荷兰国家代码是多少	荷兰
谁是windows操作系统的创始人	windows操作系统
从你的全世界路过有多长时间的情节	从你的全世界路过
运动鞋的益处	运动鞋
3d肉蒲团之极乐宝鉴的制片人	3d肉蒲团之极乐宝鉴
lotto的歌曲都是什么语言	lotto
长白山脉以哪座山为主	长白山脉
解释下jenkins是什么	jenkins
色情小说的要求是什么	色情小说
林允所在的经济公司	林允
什么技术被用于网盘上	网盘
刘诗诗上称多沉	刘诗诗
牛排的口味	牛排
端午节的饮食	端午节
杨幂来自哪家唱片公司	杨幂
谁是苹果的ceo	苹果
鲁路修·兰佩路基是什么地位	鲁路修·兰佩路基
谁是史蒂夫·乔布斯的生母	史蒂夫·乔布斯
长城在什么位置	长城
什么系统用在小米手机5上	小米手机5
文艺复兴是根据什么作为指导思想进行的	文艺复兴
空气质量指数的等级是什么	空气质量指数
中山的市花	中山
法国总统现任是谁	法国总统
osi参考模型的设定时间	osi参考模型
microsoftoffice的最新版	microsoftoffice
二甲双胍的分子构成形式是什么	二甲双胍
pmc	pmc
爱奇艺的外语你知道不	爱奇艺
立体电影又叫什么	立体电影
斗罗大陆什么时候出的第一版	斗罗大陆
陈赫有哪些口头禅	陈赫
在什么时候泰勒·斯威夫特出道的	泰勒·斯威夫特
高铁时速	时速
iphone7用的什么系统	iphone7
microusb的特性	microusb
中国历史朝代的政治体制么	中国历史朝代
唐舞麟是谁生的	唐舞
菲德尔·卡斯特罗的生辰日期	菲德尔·卡斯特罗
荨麻疹一般长在哪里	荨麻疹
深圳地铁11号线什么时候通车	深圳地铁11号线
在几度下维生素c会开始熔化	维生素c
提起四个全面就会想到谁	四个全面
node.js发布日期	node.js
麻生希都有哪些爱好	麻生希
华盛顿哥伦比亚特区的机场不	华盛顿哥伦比亚特区
十二道锋味第二季是什么公司制作的	十二道锋味
行尸走肉的绘图作者	行尸走肉
windowspowershell的平台是什么	windowspowershell
地球上海洋的体积就多大	地球
在宁夏的著名学府都有什么	宁夏
痘印是什么样子的	痘印
蓝胭脂她老爸叫什么	胭脂
ig是谁的	ig
李白真人叫什么	李白
acfun的广告口号	acfun
对数是谁研究出来的	对数
同位语要怎么用合适	同位语
岳云鹏一般都和谁合作搭档	岳云鹏
蔡依林的唱片购买量	蔡依林
肺结核通过什么传播的	肺结核
鲁路修·兰佩路基身份	鲁路修·兰佩路基
北京跟哪儿	京
喝可乐的副作用	可乐
御坂美琴有什么卓越的能力	御坂美琴
农业电子商务位于什么情况下	电子商务
重定向的操作方式	重定向
贞操带由什么时候流传下来	贞操带
质子重离子治疗技术存在的地方	重离子
见到咱们相爱吧是什么时候	相爱
京东总部在哪儿	京东
mfc可以针对哪些群体使用	mfc
张起灵的爷爷你知道是谁	张起灵
瑞士的政治体制你知道是什么	瑞士
陈寅格的背景时代是	陈寅
ascii全称	ascii
操作系统的内容	操作系统
亚洲的其他叫法还有什么	亚洲
维生素a长什么样	维生素a
火影忍者是哪个地方的	火影忍者
发行美元的公司叫什么	美元
什么时候播出梦想的声音	梦想
皇后大道东的专辑曲目总共是多少	皇后大道东
你懂里番不	你
创立富士康的是谁	富士康
windows.old的位置	windows.old
梅兰芳的民族	梅兰芳
杨永信的性别	杨永信
svchost.exe是哪家公司提供的服务	svchost.exe
谁是心经的翻译	心经
血红蛋白的组成部分	血红蛋白
中国历史朝代的政治体制是什么	中国历史朝代
王俊凯会什么	王俊凯
江苏的省会	江苏
曼莎珠华有什么含义	莎
t-ara出道时间	t-ara
哪首歌是灵魂摆渡人的原曲	灵魂摆渡
谁给摇一摇作的词	摇一摇
卢旺达种族大屠杀的死伤人数是多少	卢旺达种族大屠杀
讲讲刘备的字号	刘备
谁给从零开始的异世界生活配的音	从零开始
美国是哪个大洲的国家	美国
农历流行圈是什么	农历
丑八怪来自哪个专辑	丑八怪
什么奖的获得者是追梦赤子心	追梦赤子心
有些方法可以制作贵金属	贵金属
开华大酒店几层	大酒店
qq音乐是哪家公司的产品	qq音乐
什么样的分子式可以表示胰岛素	胰岛素
投名状拍摄耗资多少	投名状
王维创作的精华是哪些	王维
十二道锋味第二季哪家公司策划的	十二道锋味
护送唐僧取经是是谁	护送
嬗变有什么含义	嬗变
朝鲜货币有哪些	鲜货
一加手机的屏幕量出来有多大	一加手机
张若昀歌曲作品有哪些	张若昀
长沙的高等学府	长沙
spring的范围是什么	spring
都什么时候会播出妖精的尾巴	妖精的尾巴
中国历史朝代的政治体制是什么	中国历史朝代
为什么要商标注册	为什么
荨麻疹一般多好发于哪些部位	荨麻疹
嬗变代表什么意思	嬗变
固态硬盘的组成一般分为哪些	固态硬盘
青岛市工商行政管理局的办公地点	青岛市工商行政管理局
济州岛的首府位于	济州岛
巴霍巴利王电影成本有多少	巴利
步步惊心：丽还有其他译名	步步惊心
呼斯楞的音乐曲风	呼斯楞
景行厅男孩的专辑曲目	景行厅男孩
127.0.0.1的用途	127.0.0.1
mit许可证选在什么日子发布的	mit许可证
个人简历一般都有什么	个人简历
美丽新世界的作品出处	美丽新世界
去湖北能看到哪些很出名的大学	湖北
1024的节日	1024
谁开的ig	ig
三体又被称为什么	三体
贝拉克·奥巴马爱人叫啥	贝拉克·奥巴马
聚丙烯用化学式怎么表达	聚丙烯
fn功能键的具体方位	fn功能键
说一说陈赫的口头禅吧	陈赫
伊丽莎白·巴托里对什么感兴趣	伊丽莎白·巴托里
树莓派的简称	树莓派
日本的首都	日本
flowerdance所属哪张专辑	flowerdance
红茶的生物目属	红茶
php是谁发明的	php
广州国际灯光节的门票是什么情况	广州国际灯光节
宋威龙的特长吧	威龙
梦想的声音的播出时间定在什么时候	梦想
黑豹乐队的鼓手叫什么	黑豹乐队
边境牧羊犬的性格资料	边境牧羊犬
喝大麦茶的好处	大麦茶
b族维生素怎么吃	b族维生素
苏秦师承何人	苏秦
什么时候有的陈寅格	陈寅
mybatis以前的名字	mybatis
艾滋病的英文是什么	艾滋病
六味地黄丸的用途	六味地黄丸
cvt的工作内容是什么	cvt
精灵宝可梦的作者	精灵宝可梦
下载辐射避难所的app	避难所
李易峰粉丝有什么说法	李易峰
w-两个世界首放时间	w
咖喱口味如何	咖喱
最初给起的什么名	最初
张家界有机场么	张家界
聚丙烯的化学式	聚丙烯
广州国际灯光节的门票是不是免费的	广州国际灯光节
翻译下里番	翻译
酉阳杂俎是什么朝代的作品	酉阳杂俎
周二珂个人简介	个人简介
灵魂摆渡人的原曲信息	灵魂摆渡
极限挑战现在是不是正在播出中	极限挑战
血红蛋白的组成	血红蛋白
人们又称奇门遁甲为什么	奇门遁甲
超少年密码是在播状态	少年
淘宝网成立了多久	淘宝网
法国的主要民族是什么	法国
胰岛素分子式是什么	胰岛素
三体的别称	三体
这样爱了的版权归属于什么	这样爱了
王健林的母亲叫什么	王健林
酷儿身高和体重	酷儿
老炮儿的票房	老炮儿
金木研哪天出生的	金木研
陈思诚属什么的	陈思诚
唱she的歌手	she
新金瓶梅是哪个级别	新金瓶梅
东京食尸鬼的原版名称	东京食尸鬼
巴黎圣母院的建造周期有多长	巴黎圣母院
acl的原则	acl
node.js什么时候发布的	node.js
东南亚国家联盟有多大面积	东南亚国家联盟
周星驰的籍贯	周星驰
上海迪士尼乐园地处什么气候	上海迪士尼乐园
唱你曾这样问过的歌手是谁	曾
张若昀有什么经典音乐作品	张若昀
华为技术有限公司是在什么时间建立的	华为技术有限公司
辞职信的重要部分	辞职信
几个英文名	英文名
在安徽可以去哪玩	安徽
007对于喝酒的要求是什么	007
黄瓜的做法都有哪些	黄瓜
巴洛克音乐的流行年代是	巴洛克音乐
yy语音的主要负责人	yy语音
姚明的姑娘	姚明
妖精的尾巴播放时间	妖精的尾巴
中二病的反义词	中二病
金瓶梅的发行公司	金瓶梅
金木研哪天过生日	金木研
dpi代表什么	dpi
网页用拼音怎么去表达	网页
sumif函数的表达式	sumif函数
node.js发布的具体日期是	node.js
内科的治疗手段是什么	内科
熊猫烧香是谁的原创	熊猫烧香
威尼斯有什么特色的好东西	威尼斯
周星驰的籍贯	周星驰
hdmi具有什么特征	hdmi
老友记的主题曲叫什么名字	老友记
南通的名人有哪些	南通
说几首五月天最好听的歌	五月天
哪年哪月哪日开通了南京地铁3号线	南京地铁3号线
莫文蔚最喜欢的明星是哪位	莫文蔚
i在拉丁文里面排序是几	i
白茶的产地是哪里	白茶
卢旺达种族大屠杀伤亡了多少人	卢旺达种族大屠杀
那个董力你知道是哪个队的	知道
最后的问候的作词作曲是谁	最后的问候
管理学代表人物	管理学
尊重的含义么	尊重
西伯利亚雪橇犬的类别	西伯利亚雪橇犬
五星连珠会带来什么影响	五星连珠
哪儿是日本首都	日本首都
什么地方有rename	rename
网盘的技术	网盘
什么钱可以在新西兰用	新西兰
macd指标还能叫什么	macd指标
写色情小说的主要要求是什么	色情小说
杨洋有多高	杨洋
奇门遁甲号称	奇门遁甲
姜思达的学校	姜思
人民英雄纪念碑是什么级别的旅游景点	人民英雄纪念碑
大熊猫的门类么	大熊猫
什么样的马天尼是007喜好的	马天尼
126有什么简介	126
docker是哪年发行的	docker
在湖北很出名的大学有哪些	在湖北很出名的大学有哪些
神奇女侠的老爹是谁	神奇女侠
颞能组什么词	词
借记卡的运用方式有什么	借记卡
有什么要求是可行性研究报告必须做到的	可行性研究报告
西游记是什么体裁的小说	西游记
洋葱有哪些食用方法	洋葱
江苏的首府是指哪里	江苏
野子的原唱	野子
灵魂摆渡3在哪儿播	灵魂摆渡
sktelecomt1英文队名	elecom
美丽新世界存在于	美丽新世界
波雅·汉库克喜欢谁	波雅·汉库克
哪首歌是火影忍者：漩涡博人传的主题曲	火影忍者
网址中的www指的是什么	网址
哪个公司开发的unity3d	unity3d
柳岩喜欢的动物是什么	柳岩
vhd归属于什么	vhd
诸葛亮哪天长辞于世的	诸葛亮
唐朝用什么钱	唐朝
sumif函数的表达式	sumif函数
李白真实的名字是啥	李白
未央宫是有多少平方米	未央宫
三味线出自哪一张专辑	三味线
洋葱的做法具体有哪些	洋葱
齐鲁制药有限公司的占地面积能告诉我一下么	齐鲁制药有限公司
多少人为youtube工作	youtube
天猫最早叫啥	天猫
李世民什么庙号	李世民
里番是什么	里
在中国什么名字代表ppap	ppap
中秋节流传地区	中秋节
你曾这样问过的翻唱者	曾
斯里兰卡的面积的具体数字	斯里兰卡
莫文蔚有喜欢的明星	莫文蔚
wechat是哪个国家发明的	wechat
现代简约风格的起源是什么	现代简约风格
名侦探柯南剧场版作者名字是	名侦探柯南剧场版
七海千秋都喜欢什么	七海千秋
内战的预兆的创作于哪年	内战的预兆
陈赫最爱说什么话	陈赫
太阳的温度有多高	太阳
幻城的上映日期	幻城
村上春树的现居地	村上春树
哪些数字代表任天堂的邮编	任天堂
塞浦路斯的英文表达	塞浦路斯
老舍用过哪些名字	老舍
西部世界的主演么	西部世界
制作陶瓷的原材料是什么	陶瓷
迪士尼的核心在哪儿	迪士尼
春节有哪些节日活动	春节
吴亦凡的重量是多少	吴亦凡
景甜是哪的学历	景甜
web的本意是什么	web
有关新闻的其他词语	新闻
网页怎么用拼音拼出	网页
麻雀是什么种类的	麻雀
无耻之徒拍了几季	无耻之徒
英文名的例子有什么	英文名
谁和苏秦有师徒关系	师徒关系
杀生丸爱人是谁	杀生丸
宋仲基的粉丝们叫什么	宋仲基
缅甸是多大的国家	缅甸
jenkins是什么软件	jenkins
伊利诺伊大学厄巴纳-香槟分校的学校类型	伊利诺伊大学厄巴纳-香槟分校
拉希奥现在在哪里	拉希奥
拾穗者什么时候长眠于世的	什么时候
灰姑娘与四骑士的语言	四骑士
老友记主题曲的歌名能告诉我	老友记
阿特拉斯有什么相关的故事	阿特拉斯
沙溢爱人是哪位	沙溢
薛之谦是哪所学校的高材生	薛之谦
水野朝阳的身材尺寸是	朝阳
寒战２什么时候开拍的	寒战
饕餮最初的含义	饕餮
sat的俗称	sat
卢旺达种族大屠杀的死伤人数	卢旺达种族大屠杀
爱奇艺的外文名么	爱奇艺
通常可见光的速度是多少	可见光
话说加拿大的国庆是多会儿	加拿大
王维的代表作品	王维
谁是田雨橙的弟弟	田雨橙
色情小说有什么要求	色情小说
ncbi所在的国家叫什么	ncbi
小说帝霸的进度	帝霸
黄河总长多少	黄河
spring可以运行的应用有哪些	spring
虎妈猫爸的播出平台	虎妈猫爸
126简单的来说是什么	126
火龙果分类于哪个目	火龙果
cp是怎么来的	cp
欢乐颂的作曲者	欢乐颂
太阳的地表温度是多少	太阳
郑州历史上的名人都有哪些	郑州
代表青岛的车牌上的字母是什么	青岛
老舍是作家谁的笔名	老舍
亚洲的别称是什么	亚洲
李煜是什么时候的人	李煜
哪个是microsoftoffice的最新版本	microsoftoffice
雅思英文缩略	雅思
进击的巨人的是怎么定价的	进击的巨人
绘画是由什么组成的	绘画
乔任梁的星座	乔任梁
哪个歌手唱的she	she
腾讯总裁叫什么	总裁
用什么方法做拉面	拉面
在哪天t-ara出的道	t-ara
如何用外语念黑羽	黑羽
谁嫁给切·格瓦拉了	切·格瓦拉
上哪去融到钱	融
sat还可以怎么说	sat
虎妈猫爸在哪儿播	虎妈猫爸
宋仲基的粉丝	宋仲基
多高啊杨洋	杨洋
哪家公司帮杨幂发行唱片的	杨幂
哪家公司的子公司是龙珠直播	哪家公司的子公司是龙珠直播
景甜是哪里培养出来的	景甜
苏联的国家领导人是谁	苏联
runtimeerror会出现什么情况	runtimeerror
以什么为灵感创作出的cortana	灵感
中南海的地址在哪里	中南海
伪装者的原著是	伪装者
李昌钰绰号	李昌钰
菲德尔·卡斯特罗的生日	菲德尔·卡斯特罗
cvt的工作原理	cvt
玻璃的化学成分是什么	玻璃
新加坡用英语怎么说	新加坡
ac米兰足球俱乐部的对歌叫什么名字	ac米兰足球俱乐部
qq音乐是哪家公司的	qq音乐
波风水门生了谁	波风水门
当初给了刘慈欣了个什么职位	刘慈欣
美国所在的大洲是哪个	美国
microsoftoffice的最新版	microsoftoffice
林俊杰的宗教信仰是什么	林俊杰
举几个四分位数的例子	四分位数
网盘的核心技术	网盘
加利福尼亚大学伯克利分校演唱的校歌叫什么名字	加利福尼亚大学伯克利分校
重庆市南岸区天台岗小学用那句话当校训的	天台岗小学
伊利诺伊大学厄巴纳-香槟分校是什么类型的学校	伊利诺伊大学厄巴纳-香槟分校
ds能耗油多少	ds
喝大麦茶有什么作用	大麦茶
扎马斯的老师	马斯
绝世唐门的类型	绝世唐门
景行厅男孩专辑有哪些歌曲	景行厅男孩
提起matlab就知道是什么	matlab
张学良籍贯	张学良
百度百科的母公司是什么	百度百科
ncbi的国籍是什么	ncbi
文明5在哪个游戏平台	文明5
那个杨永信到底是男是女	是男是女
历史上什么时候出现了潘金莲	什么时候
高桥李依出道时间是哪年	李依
金瓶梅的发行公司名称	金瓶梅
怎么用拼音去表示网页	网页
血液透析是专门医治哪种疾病的	血液透析
研究员所干的	研究员
人民英雄纪念碑的景区级别	人民英雄纪念碑
赵云是哪个时代的人	赵云
生死狙击是几个人玩的游戏	生死狙击
微软的主要成果有哪些	微软
巴黎的宗教信仰是什么	巴黎
126的简介能告诉我	126
潘金莲生于哪个朝代	潘金莲
volte	volte
荷兰国家代码是	荷兰
哪些表现代表runtimeerror	runtimeerror
百合属于什么科	百合
黑洞直径有多大	黑洞
苏联的国家主席是	苏联
北京四环路的位置	北京四环路
冰点脱毛的原理是什么	冰点脱毛
晓得吴亦凡体重不	吴亦凡
都有哪几所高校座落在海南	海南
妖精的尾巴在什么时候播出	妖精的尾巴
蓝莓的主要作用是什么	蓝莓
乌冬面有着怎样的烹饪方法	乌冬面
人民日报什么时候首次发行于	人民日报
羊肉什么味儿	羊肉
步步惊心：丽的其他译名叫什么	步步惊心
中国的旅游胜地有哪些	中国
埃及的国花	埃及
犹太民族的伟人有哪些	犹太
必应的类别	必应
奇门遁甲号称因什么而被人们熟知的	奇门遁甲
饕餮本义是什么	饕餮
酷儿的身高体重	酷儿
崔健的唱片公司是哪家	崔健
僵尸是哪里的	僵尸
李易峰后援会名字	后援会
1989这部专辑的时间是多长	1989
哪出品的守望先锋	守望先锋
天宫一号的长度具体是多少	天宫一号
菲德尔·卡斯特罗是哪天生的	菲德尔·卡斯特罗
松花江有多少平方千米	松花江
余罪每集时间长度是多少	余罪
融资的途径	融资
行尸走肉的作画作者是谁	行尸走肉
pmo主要负责什么	pmo
海洋的体积是多少	海洋
过端午节主要吃什么	端午节
鹿晗国籍是哪儿	鹿晗
volte的意义	volte
给我一个准确的数值关于s的相对原子质量	数值
神奇女侠的父亲	神奇女侠
给我描述一下维生素a的样子	维生素a
华盛顿哥伦比亚特区机场简介	华盛顿哥伦比亚特区
小米note多少钱么	小米note
163是什么么	163
现代简约风格起源是什么学派	现代简约风格
马云的主要成就是什么	马云
中央电视台区域是什么	中央电视台
什么时候出版的斗罗大陆	斗罗大陆
南京地铁3号线什么时候开始有的	南京地铁3号线
大肠杆菌的生物种类	大肠杆菌
长征五号系列运载火箭是被哪个国家制造出来的	长征五号系列运载火箭
microsoftvisualstudio什么时候更新的	microsoftvisualstudio
带颞的词	词
灵魂摆渡人来自哪首歌	灵魂摆渡
在什么地方流传着锡克教	锡克教
拉斯维加斯具体建立的时间是多会儿	拉斯维加斯
projectglass的出售价格	projectglass
都有什么地方在杨幂刘恺威的婚礼中出现了	刘恺威
方大同唱歌什么风格	方大同
汤圆家常菜的简单做法是什么	家常菜
英魂之刃有什么样的画面	英魂之刃
microsoftonenote处于什么发行阶段	microsoftonenote
非洲的本义	非洲
maven的实质告诉我一下	maven
中央电视台的区域范围有哪些	中央电视台
博柏利是如何定位自己品牌的	博柏利
什么时候有的清明上河图	清明上河图
东南亚国家联盟的总面积	东南亚国家联盟
印度的人口	印度
西游记的体裁	西游记
小米note多少钱	小米note
什么原因产生的国有企业改革	国有企业改革
老炮儿有多少票房	老炮儿
闪电侠有什么样的能力	闪电侠
青年有什么节日	青年
谁是柏拉图的老师	柏拉图
git的读音	git
小米手机5有着怎样的系统	小米手机5
大鱼海棠制作费	海棠
web有什么特别的内涵	web
9·11事件发生地点	9·11事件
学会计去什么院系	会计
济州岛一般都在什么地方处理事务	济州岛
聚丙烯化学式的写法	聚丙烯
www的定义是什么	www
他是龙的色彩是什么感觉	是什么
哪些名字是跟swot分析法一个意思的	swot分析法
在什么时候能看到妖精的尾巴	妖精的尾巴
去海南读书的话有哪些高校可以选择	读书
163是什么形式	163
舒淇属于哪种性格的人	舒淇
银魂的出版时间	银魂
哈利·比特的电影名是	哈利
哪些杂志对哆啦a梦进行了连载	哆啦a梦
朝鲜的货币	朝鲜
购买appletv的钱数	appletv
大熊猫又名	大熊猫
jenkins是干什么用的	jenkins
华盛顿哥伦比亚特区的机场	华盛顿哥伦比亚特区
富士康创立者	富士康
搜索引擎的分类方法	搜索引擎
方大同的歌曲曲风是什么	方大同
辛普森杀妻案人物有哪些	辛普森杀妻案
黄致列的代表作么	列
bootstrap是哪个类型的	bootstrap
做哪些事情会让麻生希感到快乐	麻生希
迪拜有多大	迪拜
唱参商的那个人么	参商
李未央有妹妹吗？叫啥	李未央
过中元节的那天是哪天	中元节
玉器鉴别有几种选择	玉器鉴别
金茂大厦有多高	金茂大厦
那个很厉害的刘慈欣什么地位	刘慈欣
贞子的恋人	贞子
谁跟木心学的东西	木心
英雄联盟属于什么游戏	英雄联盟
马云的主要经历是什么	马云
周二珂做啥工作的	工
三味线出自哪一张专辑	三味线
切·格瓦拉与谁是婚姻关系	切·格瓦拉
书信的反义词么	书信
关于中国地质大学邮编的数字组合是什么	中国地质大学
给我列举几个英文名	给
苏州的人口总数	苏州
发布mit许可证的具体时间	mit许可证
哪些特点是microusb所具有的	microusb
林俊杰的宗教信仰怎么样	林俊杰
端午节主要吃什么	端午节
唐僧徒弟	唐僧
孙悟空什么来头	孙悟空
写出奇妙能力歌词的人	奇妙能力歌
谁是简单爱的合声编写	简单爱
宋小宝的师傅是谁	宋小宝
哪些名人是郑州人	州人
丁墨的所在地	丁墨
酷儿到底有多高多重	到底
bobbytinsley的音乐流派是啥	bobbytinsley
谁生产了守望先锋	守望先锋
胡歌的祖籍是哪儿的	胡歌
中秋节由什么地方流传下来	中秋节
蔡依林的专辑购买量	蔡依林
bobbytinsley是什么流派	bobbytinsley
9·11事件发生在哪儿	9·11事件
五证合一的同义词是什么	合一
梅毒的传播方式有哪几种	梅毒
ppap在中国怎么称呼	ppap
问号一般用在哪些地方	问号
建造纽约中央公园用了多少的地	纽约中央公园
.xxx通常表示什么意义	.xxx
武动乾坤中关键人物都有谁	武动乾坤
大肠杆菌属于哪个种类么	大肠杆菌
威风堂堂是谁进行的曲子创作	威风堂堂
1号店的公司口号	1号店
田馥甄的粉丝都叫什么	田馥甄
广州国际灯光节可以随便进	广州国际灯光节
火影忍者剧场版原作者名字是	火影忍者剧场版
赵雅淇的三围吧	赵雅淇
玛丽苏的近义词有哪些	玛丽苏
什么说法也代表swot分析法	swot分析法
唯品会能选择哪种语言	唯品会
墨子是哪种民族的	墨子
全国青少年网络文明公约是哪年被提出的	青少年
守望先锋是哪出品的	守望先锋
其他版本的马赛曲叫什么	马赛曲
马思纯属于哪个民族	马思纯
蓝莓有什么好处	蓝莓
在哪里能看到拉布拉多猎犬	拉布拉多猎犬
萌萌哒天团建立地点在哪里	萌萌哒天团
s的相对原子质量	s
维生素a的外观	维生素a
谁给饥荒写的曲	饥荒
父亲翻唱	父亲
二八定律还有哪种说法	二八定律
李嘉诚的夫人是哪位	李嘉诚
我的奇妙男友的编剧是谁	男友
捷克的国家领导人	捷克
红薯主要产于哪	红薯
转义字符的别称	转义字符
国际空间站能有多重	国际空间站
四个全面是谁提出的	四个全面
微微一笑很倾城被哪出品了	微微一笑很倾城
约人打羽毛球约在哪里比较合适	羽毛球
东京食尸鬼最原始的叫法	东京食尸鬼
三毛的男人	三毛
瑜伽节在几月几号过	瑜伽
东京食尸鬼最初叫啥	东京食尸鬼
那些花儿的翻唱	那些花儿
自来也喜欢谁	自来也
学术界都怎么解释天气	学术界
ip地址包含几种	ip地址
张艺兴所在的组合叫什么	张艺兴
金牛座是什么时候生的	金牛座
克里斯汀·斯图尔特的血统	克里斯汀·斯图尔特
建东南亚国家联盟到底用了多少面积	东南亚国家联盟
bigbang是干啥的	bigbang
美人鱼学名	美人鱼
釜山行的韩语是什么	釜山行
济州岛的关键在什么地方	济州岛
血液透析能够治疗哪些疾病	血液透析
动漫的意思	动漫
向日葵的格调是什么	向日葵
秋田犬是哪个国家的	秋田犬
jenkins不	jenkins
张雨绮最优秀的地方是哪些方面	张雨绮
新金瓶梅是什么级别的	新金瓶梅
163属于什么	163
可乐有哪些危害	可乐
华盛顿哥伦比亚特区的机场	华盛顿哥伦比亚特区
李昌钰被叫做什么	李昌钰
引号的作用	引号
拳皇13的画面效果是怎样的	拳皇13
ds的耗油量一般会达到多少	ds
dns劫持的影响	dns劫持
老舍别的名字有哪些	老舍
sleep函数使用教程	sleep函数
银魂出版在哪一年	银魂
如何理解资本的词义	资本
黑羽的外文名	黑羽
讲讲辅酶q10的化学式	辅酶q10
奚梦瑶的爱好	奚梦瑶
osi参考模型的设立日	osi参考模型
s.t.的英译汉	s.t.
苏秦的师父是怎样的	苏秦
极乐净土原文怎么念	极乐净土
双子座是什么样子的	双子座
中山最著名的花	中山
缘之空的发行商	缘之空
拓扑学的创办人是谁	拓扑学
行尸走肉的绘图时谁做的	行尸走肉
发行了windows10的公司是哪个	windows10
pdca循环	pdca循环
流媒体如何去播放	流媒体
莫文蔚喜欢的明星是谁	莫文蔚
深圳地铁11号线的发车时间	深圳地铁11号线
小米手机5搭载的系统是哪个	小米手机5
未央宫坐拥多大的建筑面积	未央宫
北京在什么地方	北京
windowspowershell的运行平台是什么	windowspowershell
幽门螺杆菌的分类	幽门螺杆菌
汤圆要怎么做	汤圆
守望先锋的生产者	守望先锋
中国地质大学的邮编	中国地质大学
四大天王里都有谁	四大天王
微微一笑很倾城的出品公司	微微一笑很倾城
萌萌哒天团在哪里建立	萌萌哒天团
用什么播放流媒体	流媒体
s.t.汉语怎么说	s.t.
主持了爸爸去哪儿第四季的那个人叫什么	爸爸去哪儿第四季
电脑配置代表什么	电脑配置
谁是我的奇妙男友的编剧	男友
李相赫的其他称呼	李相
核工业404的地理位置在哪里	核工业
沙溢的老婆	沙溢
英雄联盟是什么样的游戏	英雄联盟
吃苹果的好处	苹果
龚琳娜嫁给了谁	龚琳娜
想看哆啦a梦一般都去哪看	哆啦a梦
黑豹乐队的鼓手叫什么名字	黑豹乐队
提起幻灯片还会想到什么	幻灯片
什么话是陈赫老说的	什么话
生死狙击里关键的内容是什么	生死狙击
timbaland加盟哪家发片	timbaland
亲爱的，公主病什么时候开播的	亲爱的
固态硬盘的分支是什么	固态硬盘
哪些内容是生死狙击里关键的	生死狙击
写一下塞浦路斯的英文	塞浦路斯
威尼斯有哪些特产	威尼斯
多少分钟一集余罪	余罪
埃及有哪些国花	埃及
杨幂的唱片由谁印刷出版的	杨幂
呼斯楞的艺术风格	呼斯楞
张艺兴的team全称	张艺兴
核工业404在哪里	核工业
寒战2拍摄时间是哪天	寒战2
查一下无翼鸟的时速	无翼鸟
用外语说万圣节	万圣节
迈克尔·乔丹的儿子	迈克尔·乔丹
中国式关系在哪个播放软件播出	中国式关系
波风水门生的孩子是谁	波风水门
拉希奥的位置	拉希奥
玛丽苏的同义词是什么	玛丽苏
杨永信啥性别	杨永信
青岛市工商行政管理局的具体位置	青岛市工商行政管理局
国歌的音乐风格	国歌
盂兰盆节一般都干什么	盂兰盆节
秋田犬原产地是哪个国家	秋田犬
幻城什么时候出	幻城
上瘾歌手名	上瘾
翻唱父亲的有谁	翻唱
都有什么方式能融资	都
maven的本质	maven
李晨跟谁在谈恋爱	李晨
黄家驹弟弟是	黄家驹
唐家三少的外貌怎么样	唐家三少
穿越火线主要角色的名字	穿越火线
哆啦a梦在什么杂志上进行的连载	哆啦a梦
想看灵能百分百去哪个网站	灵能百分百
海洋的体积大约多大	海洋
村上春树的居住地	村上春树
sat是什么意思	sat
黑豹乐队的鼓手	黑豹乐队
流媒体播放	流媒体
哪天是诸葛亮人生中的最后一天	最后一天
西游记的体裁	西游记
网笔画是多少	网
包皮属于什么	包皮
哪些感受是运动鞋能带来的	运动鞋
一加手机的屏幕有多大	一加手机
一共有多少人归印度所有	印度
粉丝怎么喊赵丽颖	赵丽颖
汽车还有没有别的名字	汽车
粉丝们给赵丽颖起的爱称是什么	赵丽颖
多少人可以一起组队玩生死狙击	生死狙击
蓝胭脂的老爸	胭脂
伊利诺伊大学厄巴纳-香槟分校是一所什么大学	伊利诺伊大学厄巴纳-香槟分校
那个叫李白的他自己本人真的名字叫什么	李白
什么时候有的adobeillustrator	adobeillustrator
拍柠檬初上的是哪些人	柠檬
核工业404的位置	核工业
电视剧的汉语拼音是什么	电视剧
怎么称呼李易峰的粉丝	李易峰
比亚迪股份有限公司地盘有多大	比亚迪股份有限公司
新陈代谢的词义	新陈代谢
牛排有几种口味	牛排
在哪里玩文明5	文明5
爱新觉罗·玄烨在位时的年号叫什么	爱新觉罗·玄烨
说几个新闻的同义词吧	新闻
广州的邮编	广州
魅族有多少人	魅族
那个到底是谁啊在w-inds.中做主唱	w-inds.
血液透析专治什么病	血液透析
美国举行大选地方是	美国
磁力链接涉及的领域	磁力链接
林正英以前叫啥	林正英
126的简单介绍是什么	126
五位一体出自于哪	五位一体
广州邮编么	广州
巴黎人信仰的宗教是哪个教	巴黎人
秘鲁用的时区叫什么	秘鲁
英魂之刃画面是	英魂之刃
美元是发行于哪家公司	美元
杨洋多高	杨洋
qq音乐开放商有哪些	qq音乐
熔炉是谁写的	熔炉
四分位数的举例	四分位数
thebeatles的音乐特点	thebeatles
聚乙烯的沸点有多高	聚乙烯
拓扑学是谁提出的	拓扑学
李未央妹妹的真名	李未央
海绵宝宝还叫什么	海绵宝宝
ds的耗油量是多少	ds
长征五号系列运载火箭产生于哪里	长征五号系列运载火箭
哪里是贵州的省会	贵州
自然常数公式	自然常数
谁参与了辛普森杀妻案	辛普森杀妻案
三极管是由什么构成的	三极管
谁为jira出的钱	jira
唱我要你的歌手	我要你的
新西兰的货币	新西兰
农业电子商务在什么状态下	电子商务
重定向的做法	重定向
海绵宝宝的别称	海绵宝宝
当归的种类划分	当归
诛仙里的重要人物	诛仙
胰岛素的分子式长什么样	胰岛素
流媒体在什么上面播放	流媒体
张国焘的逝世地点是哪里	张国焘
马东敏的名字	马东敏
巴霍巴利王制作费是多少	巴利
地球有多重	地球
神奇女侠是谁的女儿	神奇女侠
百度公司叫什么名字	百度公司
老炮儿总共赚了多少钱	老炮儿
最后的问候的作词作曲	最后的问候
蒙奇.d.路飞的配音演员都有谁	蒙奇
腾讯的老板	腾讯
刺客信条：大革命的主角名字	刺客信条：大革命
你觉得唐家三少的长相怎么样	唐家三少
去旧金山用啥时区	旧金山
表示如果蜗牛有爱情的编码数字是什么	如果蜗牛有爱情
云盘有哪些原理	云盘
蓝染惣右介的花语	蓝染惣右介
辅酶q10的化学式	辅酶q10
哪个国家拍了步步惊心··丽	步步惊心
奔跑吧兄弟的录音	奔跑吧兄弟
罗马数字的拼音是什么	罗马数字
s.t.翻译成中文	s.t.
细颗粒物单位	细颗粒物
六味地黄丸的作用	六味地黄丸
内战的预兆的创作年份	内战的预兆
顺丰速运是什么地方开创的	顺丰速运
余罪每集时长	余罪
自来也喜欢哪个人	自来也
扎马斯的老师叫什么	马斯
德国国歌	德国国歌
blackpink的工作	black
身体乳这东西到底是干什么用的	身体乳
发现最小二乘法的人是哪个	最小二乘法
北京处于什么地区	北京
马云的主要经历	马云
ptc含有什么物质	ptc
广州的邮编是多少	广州
老炮儿获得多少经济效益	老炮儿
网这个字总笔画数	网
iphone6的颜色	iphone6
走向共和都在哪些地方发行了	走向共和
运动鞋让我们在哪些方面受益	运动鞋
如何简单的描述fscanf	简单
大家平时在哪里打羽毛球	羽毛球
百度糯米的具体位置	百度糯米
爱新觉罗·玄烨的名号	爱新觉罗·玄烨
雪儿的歌曲是什么风格	雪儿
德国的国歌名是	德国
莫文蔚的偶像是谁	莫文蔚
site怎么翻译	ite
灰姑娘与四骑士是什么语言的	四骑士
latex的属性	latex
过端午节一般讲究吃什么	端午节
组策略的领域	组策略
景行厅男孩的专辑歌曲	景行厅男孩
angelababy哪年生的	angelababy
能不能解释下资本	资本
蜂蜜是如何形成的	蜂蜜
谁是龚琳娜的老公	龚琳娜
朴灿烈所属组合叫什么	朴灿烈
无耻之徒上映了几季	无耻之徒
法国的主体民族是什么	法国
宋威龙的技能特点是	威龙
未央宫的建筑面积	未央宫
关于s硫元素它的相对原子质量是多少	硫元素
谁写的律政强人剧本	强人
伊丽莎白·巴托里对什么着迷	伊丽莎白·巴托里
平凡的世界第一次出版时间	平凡的世界
文艺复兴的指导思想是什么	文艺复兴
中国的旅游胜地	旅游胜地
ds的耗油量是多少	ds
东京的总人数	东京
舒淇是如何让自己被人喜欢的	舒淇
陈赫最喜欢用那句话说自己	陈赫
谁是江苏的首府	江苏
谁是蓝胭脂她老爸	胭脂
种葡萄的海拔要求范围是多少	葡萄
蔡依林的专辑有多少销量	蔡依林
济南特产的品种是什么	南特
滇西科技师范学院的校训	学院
守望先锋的厂商具体名字叫什么	守望先锋
谁是波雅·汉库克喜欢的人	波雅·汉库克
s.t.的汉语是	s.t.
杨洋的身高不	杨洋
七月与安生的书名是什么	七月与安生
香港的电话区号	香港
圣诞节是哪天不	圣诞节
猫咪老师的样子怎么来的	猫咪老师
facebook分在什么类公司里	facebook
演过赵敏的都有谁	赵敏
无花果的门类	无花果
爱奇艺的英文名么	爱奇艺
金毛寻回犬都能长到多高	寻回犬
flytothesky是什么唱法	flytothesky
淘宝网成立在什么时候	淘宝网
在什么时候苏轼归西了	什么时候
大鱼海棠制造成本	海棠
绝命毒师的奖项	绝命毒师
乌台诗案的时间是多会儿	乌台诗案
检察官在哪儿工作	检察官
詹天佑处于	詹天佑
灵能百分百在什么网站上连续刊登的	灵能百分百
田馥甄粉丝统一叫什么	田馥甄
宋仲基粉丝名称	宋仲基
荷兰的国家代码是什么	荷兰
罗马数字怎么读	罗马数字
三味线是哪个专辑	三味线
香港的电话区号	香港
作者是以哪个时间为背景创作了荷塘月色	荷塘月色
哪个歌手唱的参商	唱
幽门螺杆菌是哪个界的	幽门螺杆菌
北京是哪个地区的	北京
西伯利亚雪橇犬的种类是什么	西伯利亚雪橇犬
梅兰芳是什么民族族群的	梅兰芳
四大天王的组成人员	四大天王
牛排是一种什么口感	牛排
google公司是哪家的	google公司
唐纳德·特朗普又叫什么	唐纳德·特朗普
pthread_cond_wait的搭配	pthread_cond_wait
蓝光技术应用于哪些领域	蓝光
秦始皇离世时多大年龄	秦始皇
拙政园面积概况	拙政园
中国好玩的景点	国
潘金莲处于什么时期	潘金莲
德国国歌名字	德国
神舟十一号飞船在哪里发射的	神舟十一号飞船
木村拓哉身上的优点是	木村拓哉
市净率是怎样计算的	市净率
lachata专辑收录什么歌	lachata
strstr的脚注	strstr
哪位导演拍的有点儿意思	拍
云盘里面的核心是什么	云盘
那些城市做过南北朝首都	南北朝
提起冬至会想到哪个季节	冬至
马赛曲还叫什么	马赛曲
重庆所在区域叫什么	重庆
qfii的位置是	qfii
中国知网的官网	中国知网
蓝胭脂她爹	胭脂
崔健的唱片公司	崔健
三体还有哪些名字	三体
iphone6s是什么牌子的	iphone6s
匈牙利的中央银行被称为	匈牙利
给我解释下饕餮的本义	饕餮
双鱼座哪儿和别人不一样	双鱼座
scratch有什么性质	scratch
runtimeerror一般会带来什么	runtimeerror
北京的所属地区	北京
什么理论可以阐述新干线	新干线
威尼斯这个地方主要有什么特产	威尼斯
哪个女星是李晨女友	李晨
大鱼海棠电影投资成本	海棠
赵敏的角色都有谁去扮演过	赵敏
谁教过游坦之	游坦之
可行性研究报告的要求是什么	可行性研究报告
sumif函数的表达式么	sumif函数
厦门有什么方言么	厦门
一般什么在车牌上代表来自青岛	青岛
如果蜗牛有爱情在国际用什么编号表示	如果蜗牛有爱情
重庆北站南广场的车站级别是什么	重庆北站
酉阳杂俎出自哪个朝代	酉阳杂俎
聚乙烯在什么温度下可以达到沸点	聚乙烯
华为音乐音乐版权是什么	华为音乐
cfr在哪个领域中是术语	cfr
咱们相爱吧啥时候面向大众的	咱们相爱吧啥时候面向大众
钟丽缇会说什么话	钟丽缇
虎牙位置在哪里	虎牙
穿越火线主角名单	火线
在哪些地方会看到有人打羽毛球	羽毛球
李世民的庙号	李世民
加利福尼亚大学伯克利分校的校歌歌名叫什么	加利福尼亚大学伯克利分校
cortana最初是什么	cortana
电脑是哪年建造的	脑
怎么用化学式表达出聚丙烯	聚丙烯
城寨英雄在谁的监督下完成的	英雄
kvm的优点是什么	kvm
简单来说126到底是什么	简单
什么时候开拍寒战２	寒战
老友记主题曲的名字	老友记
奇妙能力歌的歌词创作者是谁	奇妙能力歌
重庆市南岸区天台岗小学的校训内容吧	天台岗小学
著名的高等院校有哪些在洛阳	些
梅毒的传播方式有哪几种	梅毒
bigbang的国籍	bigbang
巴厘岛说哪国话	巴厘岛
秋葵是哪科的	秋葵
web的含义是什么	web
什么是jenkins	jenkins
西伯利亚雪橇犬的种类	西伯利亚雪橇犬
尹恩惠是什么毕业	尹恩惠
www包括哪些含义	www
摩洛哥的人口是多少	摩洛哥
芒果汁的做法都有些什么	芒果汁
罗永浩生日是几月几号	罗永浩
苏轼在什么时候寿终正寝的	苏轼
鹿晗是哪国人	鹿晗
谁收游坦之为徒了	游坦之
成都的电话区号是多少	成都
nba是啥时候创立的	nba
二甲双胍的分子构成形式	二甲双胍
四大天王的队员是谁	四大天王
范冰冰血型的种类是	范冰冰
microusb有什么特点	microusb
北魏一共有多少人	北魏
mac地址的含义	mac地址
千图网怎么好用	千图网
美国大选的举办地	美国
新金瓶梅被划分为什么级别	新金瓶梅
普及下大熊猫的门类知识	大熊猫
供应链的来源	供应链
苏小妹的亲爹是哪个	苏小妹
lachata专辑都有哪些曲子	lachata
六味地黄丸的药用价值	六味地黄丸
vlookup函数干嘛用的	vlookup函数
lemontree谁唱的	lemontree
名侦探柯南剧场版的原作是谁	名侦探柯南剧场版
李相赫的外号	李相
浙江大学的校址	浙江大学
生死狙击都是什么主题内容	生死狙击
哪种思想导致了文艺复兴运动发生的	文艺复兴
给我说下杨永信是男是女	杨永信
python于何时面向大众的	python
机械键盘的具体优势有哪些	机械键盘
web的本意	web
比热容的单位数值是多少	比热容
识汝不识丁的特征	识汝不识丁
中东的宗教信仰是什么	中东
铁凝的姓氏	铁凝
sktelecomt1英文队名是什么	elecom
村上春树居住城市	村上春树
三里屯能开放多少小时	三里屯
acl有哪些准则	acl
你懂动漫的含义不	动漫
谷歌学术的作用	谷歌
鬼节的设立日	鬼节
谁是奔跑吧兄弟的录音	奔跑吧兄弟
澳大利亚有哪些著名城市	澳大利亚
巴霍巴利王制作成本多少	巴利
哪些技术应用在了网盘上	网盘
什么时候有了人民日报的	人民日报
原来你还在这里的台词语言	原来你
张起灵的爷爷到底是谁	张起灵
1024是什么特别的日子	1024
比热容有哪些单位	比热容
hao123是哪个公司的产品	hao123
hao123的总公司	hao123
西伯利亚雪橇犬的族群	西伯利亚雪橇犬
李晨现在的女友是哪个？李晨的对象是	李晨
岳云鹏的搭档是谁	岳云鹏
谁发明的摩尔斯电码	摩尔斯
小别离制片人是谁	小
怎么做乌冬面	乌冬面
李相赫的外号	李相
波风水门的儿子是哪个	波风水门
谁是qq音乐的老板	qq音乐
鸡蛋果的属是什么	鸡蛋果
如何用借记卡	借记卡
汉江流域多大么	汉江
捷克的国家领袖	捷克
周杰伦的床边故事的专辑语言	床边故事
jenkins是什么	jenkins
临江仙是什么时候流传下来的	临江仙
塞卡病毒是什么引起的	病毒
十二道锋味第二季的制作公司	十二道锋味
消防宣传日的习俗么	消防宣传日
海词词典的创始年份	海词词典
孤独怎么翻译	孤独
windows10是由谁发行的	windows10
景行厅男孩的专辑歌曲有哪些	景行厅男孩
bmi指数的简要名称是什么	bmi指数
组策略的所属领域是什么	组策略
走着走着就散了是哪个混音师做的	走着走着就散了
加拿大人什么时候过国庆	什么时候
中国新歌声的主持人都有谁	新歌
怎么用借记卡	借记卡
英文i来源于哪	英
得抑郁症的人都有什么共同点	抑郁症
cvt的工作方法	cvt
林志颖的母亲是谁	林志颖
犹太最出名的是谁	犹太
t-ara的出道时间吧	t-ara
pthread_cond_wait该如何搭配	pthread_cond_wait
迈克尔·乔丹的儿子是谁	迈克尔·乔丹
microsoftofficeaccess用于什么方面	microsoftofficeaccess
bootstrap的类型	bootstrap
春节的节日活动	春节
大熊猫还有其他名字没	大熊猫
mfc一般什么人去用	mfc
北京四环路的坐标	北京四环路
灵蝶身份是什么	灵蝶
哪些人是九州·天空城的主演	天空城
黑洞直径是多少	黑洞
这次的亚洲足球锦标赛在哪里举行	亚洲足球
铁凝到底是什么姓氏的	铁凝
几个玛丽苏的同义词	玛丽苏
查克·赫尔是摩尔斯电码的发明人	赫尔
秦始皇的年龄	秦始皇
龚琳娜老公	龚琳娜
北京故宫面积是怎样的	北京故宫
微软的主要产品	微软
章泽天的爱人	章泽天
田馥甄粉丝的别号是什么	田馥甄
王俊凯的特长是什么	王俊凯
杭州的面积	杭州
为什么会有选举人票	选举人票
半月板大部分的生病原因来自	半月板
ip地址的类型分几种	ip地址
幻灯片又指的是什么	幻灯片
民族乐派出现的时期	民族乐派
x射线的特征	x射线
庆端阳的词曲是谁写的	庆端阳
丢番图什么时候去世的	丢番图
复旦大学的学校地址	复旦大学
acfun的宣传口号	acfun
南北朝历代首都	南北朝
章泽天的恋爱对象是谁	章泽天
谁写的名侦探柯南剧场版	名侦探柯南剧场版
谁编的我的奇妙男友	男友
周星驰老家在哪儿	周星驰
网页怎么读	网页
浙江大学的地址	浙江大学
国有企业改革是如何产生的	国有企业改革
互联网的概念是什么	互联网
林中鸟词曲	林中
丁墨所在地方	丁墨
www指代什么	www
林丹的运动项目全称叫什么	林丹
上古卷轴5是谁做出来的	上古卷轴5
胡歌的祖籍	胡歌
自考专升本的学历怎么算	自考专升本
可见光的速度	可见光
可见光的平均速度	可见光
太阳表面上的温度大概有多高	太阳
南京地铁3号线是哪天开通的	南京地铁3号线
刘邦去世了多久	刘邦
谁翻唱的父亲	父亲
辛亥革命的核心人物	辛亥革命
到底加了多少东西进去才做出这担仔面的	担仔面
蔡依林的唱片销量是多少	蔡依林
完美世界的出版机构是哪里	完美世界
顺丰速运的成立地点	顺丰速运
妖精的尾巴什么时候播放	妖精的尾巴
史蒂夫·乔布斯的母亲	史蒂夫·乔布斯
自然常数的计算方法是什么	自然常数
美国的大洲是五大洲的哪一个	美国
色情小说的要求是什么	色情小说
有python的那年是什么时候	python
供应链的起源	供应链
贞子的恋人是谁	贞子
秦始皇多少岁逝世的	秦始皇
arduino的创始者是谁	arduino
松花江的流域有多少平方千米	松花江
鸡蛋果的属类	鸡蛋果
用什么表示比热容	比热容
dpi的意思	dpi
磁力链接应用于什么领域	磁力链接
超少年密码的播出情况	少年
闪电侠有没有特殊的能力	闪电侠
新西兰使用什么货币	新西兰
铣床主要进行的是哪种运动	铣床
有哪些基础是内容分发网络的	内容分发网络
玉米的原唱歌手是哪位	玉米
谍影重重的分级吧	谍影重重
张国焘是在哪里逝世的	张国焘
163邮箱的用途都有什么	163邮箱
林允的经纪公司是哪个	林允
刘邦的死亡时间是	刘邦
李世民死后叫什么	李世民
史蒂夫·乔布斯的生母是谁	史蒂夫·乔布斯
亚洲足球锦标赛的举办地点	亚洲足球
多少钱流入老炮儿的票房	老炮儿
新海诚的出生地在哪儿	新海诚
邓紫棋喜欢吃的东西	邓紫棋
潘金莲所生活的朝代是什么时候	潘金莲
父亲翻唱是谁	父亲
神印王座的创作者	神印王座
你看你看月亮的脸发行商	你看你看月亮的脸
择天记是在哪里首次发布的	择天记
杨幂的唱片版权归哪家公司	杨幂
锦绣未央价格	锦绣未央
朋克来源于什么时期	朋克
珠穆朗玛峰的门票多少钱一张	珠穆朗玛峰
给我看下胰岛素的分子式	胰岛素
沈腾的姐姐是哪位	沈腾
拳皇13用了什么画面技术	拳皇13
想打羽毛球的话去哪里比较合适	羽毛球
lorde的音乐流派	lorde
纪昀活了多少岁	纪昀
通常都用哪些东西进行在线翻译	在线翻译
猫是什么纲目的	猫
张国荣的爱好	张国荣
上古卷轴5制作人	上古卷轴5
一直播使用资费是多少	一直播使用资费是多少
斯里兰卡有多大	斯里兰卡
能看到哆啦a梦连载的杂志都有哪些	哆啦a梦
抖s的对义词是哪个词	抖s
qq什么时候有的新版本	qq
谁是简单爱的合声编曲	简单爱
辐射避难所的游戏下载地址是什么	避难所
陈绮贞歌曲风格是	陈绮贞
戚继光有什么轶事	戚继光
迪士尼的指挥中心在哪	迪士尼
写字板又是什么东西	写字板
给我一个金毛寻回犬高度的参考范围	寻回犬
闪电侠的能力是什么	闪电侠
澳门有多少人么	澳门
华山有着怎样的长度	华山
vlookup函数的功能你懂么	vlookup函数
管理学被谁所代表的	管理学
乌台诗案所发生的时间是什么时候	乌台诗案
花千骨拜谁为师了	花千骨
五证合一的同义词	合一
能进行在线翻译的工具都有什么	在线翻译
高血压病因有哪些	高血压
巴厘岛说哪国语	巴厘岛
金毛寻回犬的高度	寻回犬
呼斯楞的歌曲风格	呼斯楞
美国的大洲是哪一个	美国
s标准的原子相对质量是多少	原子
h.264算什么	h.264
唐三的女婿是谁	唐三
三里屯能玩多长时间	三里屯
中南海的具体位置是	中南海
天猫原名叫什么	天猫
动漫的定义么	动漫
英文名的例子	英文名
雪鹰领主里的关键人物叫什么	领主
猫咪老师最初是什么	猫咪老师
如何求出扭矩的数值	扭矩
十二道锋味第二季由谁制作的	十二道锋味
哪类生物有幽门螺杆菌	幽门螺杆菌
疯狂动物城的imdb编码	动物城
王维的作品最主要的有哪些	王维
怎么服用b族维生素	b族维生素
网易公司的股票上市号码	网易公司
丢番图在什么时候结束的生命	丢番图
pthread_cond_wait和什么组合在一起效果更好	pthread_cond_wait
借记卡的使用方法有哪些	借记卡
贵金属的制作工艺有哪些	贵金属
穿越火线的主要人物	穿越火线
python正式发行的时间	python
从零开始的异世界生活的主要配音	从零开始
1989的播放时间达到了多长	1989
自传的歌手	自传
腾讯老板是哪位	腾讯
数据结构的作用	数据结构
论文格式有哪几种	论文格式
比亚迪股份有限公司坐拥多大的面积	比亚迪股份有限公司
北京故宫占了多少土地	北京故宫
哪位是杜隆坦的好朋友	杜隆坦
windows.old的位置不	windows.old
上古卷轴5的制作人是谁	上古卷轴5
dns劫持所造成的后果	dns劫持
简述一下fscanf	fscanf
投名状制作成本	投名状
铳皇无尽的法夫纳被谁创作出来的	铳皇无尽的法夫纳
马东敏的名字	马东敏
看完从你的全世界路过需要多久	从你的全世界路过
幻灯片还代表什么东西	幻灯片
国歌是什么音乐风格	国歌
绘画主要由什么构成	绘画
龙珠直播是由哪家公司主办的平台	龙珠
中国新歌声的主持人	新歌
什么样的方法可以做乌冬面	乌冬面
哪发行了走向共和	走向共和
匈牙利的中央银行是什么	匈牙利
谁帮奇妙能力歌填的词	奇妙能力歌
哈利·波特的作品有哪些	哈利·波特
三极管应用到什么材料	三极管
周星驰的籍贯是哪儿	周星驰
这种机械键盘有啥好的优势	机械键盘
voc会让人有哪些不适	voc
最初有电影的地方是哪儿	电影
中东信仰什么宗教	中东
床头柜是怎么拼的	床头柜
柳岩喜欢的动物	柳岩
行尸走肉的绘图作者是谁	行尸走肉
双鱼座的特征是啥	双鱼座
天宫一号的全长是多少	天宫一号
曹操的谥号	曹操
游戏人生的游戏画面	游戏人生
幻灯片版式用于什么地方的	幻灯片
什么人能应用这个mfc	mfc
京韵大鼓的流行地区	京韵大鼓
百度公司名称	百度公司
ra485长度是怎样的	485
谁是赵一荻的老公	赵一荻
王牌逗王牌的对白是哪国的语言	王牌
希拉里·黛安·罗德姆·克林顿的学位	希拉里·黛安·罗德姆·克林顿
张国荣有什么爱好	张国荣
车牌上如何表示代表青岛	车牌
百度是什么公司旗下的	百度
李晨现在跟谁在一起	李晨
美国队长3的制作成本大约是多少	美国队长3
visa的其他翻译方式是啥	visa
想在线翻译一般都用什么	在线翻译
梅兰芳的民族族群	梅兰芳
希尔薇几岁么	希尔
许巍有哪些喜好	许巍
黄河河长是什么	河长
周星驰的原籍	周星驰
完美世界的出版机构	完美世界
星座最开始在什么地方出现	星座
荷兰的国家代码	荷兰
章鱼哥朋友名字	章鱼哥
劳尔·卡斯特罗的哥哥到底是谁	劳尔·卡斯特罗
担仔面里面都放了什么东西	担仔面
王心凌男朋友叫什么	王心凌
神奇女侠的父亲是哪位	神奇女侠
维生素c的熔点	维生素c
柳岩对哪种动物感兴趣	柳岩
英雄联盟到底是什么游戏	英雄联盟
吴启华日常住在哪儿	吴启华
希尔薇的年龄	希尔
亚洲的意译是什么	亚洲
狼人杀属于什么游戏	狼人杀
资本的意思	资本
杨永信是哪个	杨永信
请叫我英雄被谁翻译出来的	请叫我英雄
人民日报什么时候可以开始出版发行的	人民日报
为什么要做心脏搭桥手术	心脏搭桥手术
用英文说演员	演员
什么代码在车牌上代表青岛	车牌
景甜的母校是哪里	景甜
赵冀龙身高体重多少	赵冀龙
麻生希乐意做些什么事情	麻生希
马云都有哪些成就	马云
简单爱的合声是谁编曲的	简单爱
谁负责的城寨英雄日常运作与策划	的城寨英雄日常运作与策划
辐射避难所在哪下载	避难所
fn功能键的准确地是什么	fn功能键
太阳达到的温度	太阳
天安门最初是什么时候开始建造的	天安门
姜思达的母校	姜思
四象限法则讲了什么	四象限法则
刘贺的陵墓你晓得不	刘贺
拉布拉多猎犬在哪里能生存	拉布拉多猎犬
谁是欢喜密探的导演	欢喜
六味地黄丸的作用	六味地黄丸
白茶的核心产地在哪里	白茶
抑郁症会带来什么	抑郁症
北京四环路的地理位置	北京四环路
从零开始的异世界生活里的主要配音演员都有谁	从零开始
乌台诗案发生的事是什么时候	乌台诗案
t-ara出道是在什么时候	t-ara
三毛丈夫是谁	三毛
澳门的总人数你晓得么	澳门
御坂美琴的能力	御坂美琴
什么学科里有氨基酸	氨基酸
那个w-inds.的主唱全名叫什么	w-inds.
林正英的曾用名	林正英
是从哪里发展出的c语言	c
不为谁而作的歌的曲风么	歌
ds的耗油量	ds
we角逐的赛事	we
哪儿是胡歌的老家	胡歌
华为技术有限公司的建立时间是多会儿	华为技术有限公司
原来你还在这里的台词语言是什么	原来你
runtimeerror都有哪些表现	runtimeerror
解释一下ce认证的含义	ce认证
美国的所属洲	美国
李晨现在有女友吗？是谁	李晨
ds大概会耗多少油	ds
犹太人里面谁出名	犹太人
身体乳这种东西是怎么用的	身体乳
市净率是如何计算的	市净率
搜索引擎有几种分类	搜索引擎
平凡的世界首次出版时间	平凡的世界
透明质酸的化学式	透明质酸
宣太后死后叫什么	宣太后
行尸走肉的漫画作者是谁	行尸走肉
去张家界可以到哪个机场	张家界
阿里巴巴集团的总部地点	阿里巴巴集团
李昌钰有哪些外号	李昌钰
苹果的首席执行官是谁	苹果
ascii是什么	ascii
iphone6的可选颜色有哪些	iphone6
湖北著名的大学	湖北
辐射避难所能在哪些地方下载	避难所
汉语拼音如何去标注1	汉语拼音
谁是天龙八部最大的制片人	天龙八部
一帘幽梦有哪些明星翻唱过	一帘幽梦
秦时明月之君临天下的别名还有什么	秦时明月之君临天下
|燃生命之火,享丰富人生是什么花的花语	生命
五位一体具体提出地是哪儿	五位一体
谁唱得玉米这首歌	玉米
刘慈欣当上了什么官	刘慈欣
章鱼哥朋友都有谁	章鱼哥
怎么拼写悦字	悦
埃及国花	埃及
好奇堺雅人的爱人是谁	堺雅人
英雄联盟的游戏属性	英雄联盟
李白真正的名字叫什么	李白
马赛曲还有别的名字	马赛曲
薛之谦大学读的是啥	薛之谦
碳酸氢钠的密度是多少	碳酸氢钠
哪些名人是考上麻省理工学院大学的学霸	麻省理工学院
迪拜面积	迪拜
阴丽华身上有着什么样的故事	阴丽华
lachata专辑有什么歌	lachata
扭矩如何用数目表示	扭矩
一共有多少人生活在东京	生活
琅琊榜首播年份	琅琊榜
一拳超人的原创是谁	一拳超人
氨基酸是什么学科的	氨基酸
爱新觉罗·溥仪的字号	爱新觉罗·溥仪
长城的地理位置	长城
1989的专辑时间	1989
都有什么活动在秦岭开过	有什么
哪些高等学校建在了海南	海南
百合的属性是什么	百合
幻灯片版式是哪里的	幻灯片
哪个是张家界的机场	张家界
区块链的特性	区块链
英魂之刃是什么电影	英魂之刃
张国焘在哪儿去世了	张国焘
河北华夏幸福足球俱乐部的角逐赛事	河北华夏幸福足球俱乐部
游击队歌被谁演唱的	游击队歌
幻城什么时候上映的	幻城
马赛曲的其他版本	马赛曲
怎么做玉器鉴别	玉器
魅族雇了多少员工	魅族
北京处于中国什么位置	北京
皇家马德里足球俱乐部的老大是谁	皇家马德里足球俱乐部
hash是啥	hash
李晨女友是谁	李晨
选举人票的造成原因	选举人票
广州国际灯光节是不是免费的	广州国际灯光节
生死狙击里重要的内容是什么	生死狙击
007有什么样特殊的癖好	007
咖喱的味道	咖喱
秋田犬是哪个国家的品种	秋田犬
维密天使的当家花旦是谁	维密天使
河北华夏幸福足球俱乐部隶属于什么联赛	河北华夏幸福足球俱乐部
李相赫还被叫做什么	李相
007特别喜欢什么样的食物	007
有多少人在魅族工作	魅族
喜欢贾云馨的是什么团体	贾云馨
平凡的世界的首版时间	平凡的世界
微软的mit许可证什么时候与我们见面的	微软
如何拼读网页	网页
李易峰粉丝叫什么	李易峰
核工业404的坐标在哪块儿	核工业
刘备的字号	刘备
简单解释下fscanf	fscanf
毛泽东哪天去世的	毛泽东
九州·天空城的主演都有哪些人	天空城
哪项大奖被追梦赤子心抱走了	追梦赤子心
北京的所属地区是哪儿	北京
可口可乐的副作用	可口可乐
是谁生的王思聪	王思聪
甘雅丹的唱歌风格是啥	甘雅丹
德国用那首歌当国歌	德国
唐僧徒弟的名字是	唐僧
神舟十一号飞船的发射地点	神舟十一号飞船
163的形式	163
mindgeek是哪个公司机构的研发产品	geek
谁唱得美丽的春天	美丽的春天
青云志是哪个国家的	青云志
运动鞋有益的地方	运动鞋
乌台诗案发生在哪个时间段	乌台诗案
幻城是哪年的电影	幻城
聚氯乙烯的颜色	聚氯乙烯
谢霆锋孩子是谁	谢霆锋
什么时候更新的qq	qq
非洲本意指的是啥	非洲
网盘包含了什么技术	网盘
林允儿是什么血型的人	林允儿
appletv标价多少	appletv
说一说av女忧的代表人物吧	av
什么组成了操作系统	操作系统
贵州的首府城市	贵州
还能叫诗经什么	能
1024这天在过什么节日	1024
什么东西被称为互联网	互联网
谁是美丽的春天的原唱	美丽的春天
lachata专辑曲子	lachata
维生素a看起来有什么特点	维生素a
文明5通过那个平台可以玩	文明5
墨子是什么民族的	墨子
那个是赵匡胤的陵墓	赵匡胤
你曾这样问过是谁唱的	曾
民国四大美男都包括谁	民国四大美男
喜欢你这首歌的原唱是谁	喜欢你
那些花儿的翻唱是谁	那些花儿
那个出品了守望先锋的厂商叫什么	守望先锋
谷歌学术的作用	谷歌
小幸运的中文名	幸运
正态分布的发现者	正态分布
杀生丸跟谁在一起了	杀生丸
丁墨所在的位置	丁墨
庄子让人铭记的是哪些作品	庄子
赵雷在什么流派里面	赵雷
黄河流长多少千米	河流
des还有什么种类	des
后来的原版叫什么	后来
动画片火影忍者剧场版谁写的原著	火影忍者剧场版
中国地质大学邮编长什么样	中国地质大学
四糸乃都喜欢什么么	四糸乃
股票型基金有什么涵义	股票型基金
都有哪里适合拉布拉多猎犬生活	拉布拉多猎犬
b族维生素怎么去服用	b族维生素
扮演猪八戒的演员是哪位	猪八戒
拉希奥的地理位置	拉希奥
釜山行的韩语么	釜山行
去威尼斯一般会带哪些特产	威尼斯
那个连续刊登了灵能百分百的网站叫什么	灵能百分百
爱新觉罗·玄烨在位时的尊称叫什么	爱新觉罗·玄烨
谁唱过我要你	我要你
你会写透明质酸的化学式	透明质酸
美人为馅的书名叫什么	美人为馅
如何书写sumif函数的表达式	sumif函数
如果蜗牛有爱情的isbn是多少	如果蜗牛有爱情
西游记是什么体裁	西游记
vlookup函数的功能有啥	vlookup函数
悦的拼音怎么拼写	悦
电子商务的定义	电子商务
谁是威风堂堂的编曲	威风堂堂
microsoftoffice的最新版么	microsoftoffice
电影的发源地	电影
欧洲最早指什么	欧洲
曹操被封为什么	曹操
数据库指什么	数据库
李世民去世后叫什么	李世民
泰勒·斯威夫特的出道时间	泰勒·斯威夫特
海洋的体积计算所得是多少	海洋
引号是干什么用的	引号
瓜德尔港是哪个城市的	瓜德尔
出师表有哪些别称	出师表
奇迹暖暖对战平台是哪个	奇迹暖暖
电视剧如何去发音	电视剧
谁跟杀生丸恋爱的	杀生丸
哪年播的琅琊榜	琅琊榜
景甜在哪念的书	景甜
兔子有什么食性	兔子
公主头属于哪类的	公主头
唱玉米的人是谁	玉米
黄河有多少公里	黄河
巴黎圣母院从开始建造到建成一共用了多久	巴黎圣母院
百度是哪家公司的	百度
这样爱了的版权归属	这样爱了
梅毒的传播途径有哪些	梅毒
拉面怎么做	拉面
秦时明月之君临天下用中文翻译过来是什么	秦时明月之君临天下
亚洲用其他名字怎么翻译	亚洲
姜思达曾经在哪里上的学	姜思
北京故宫占地面积	北京故宫
江苏的省会么	江苏
五四运动的影响是怎样的	五四运动
vhd的由来	vhd
柳岩心爱的动物	柳岩
任天堂的邮编	任天堂
五四运动影响	五四运动
历史上的铁凝是什么姓氏出生	铁凝
重庆市南岸区天台岗小学的校训不	天台岗小学
黑洞直径是多少么	黑洞
国有企业改革产生原因	国有企业改革
张起灵的祖父叫什么	张起灵
appletv的价值是	appletv
微微一笑很倾城的颜色有什么	微微一笑很倾城
孙悟空是哪的人	孙悟空
第一次见到python是在什么时候	第一次
可见光的通常速度	可见光
自来也喜欢的人叫什么	自来也
裴秀智运动的方法有哪些	裴秀智
微软的主要产品有哪些	微软
广州国际灯光节是免费的	广州国际灯光节
什么是狗带	狗
那个发行了金瓶梅的公司叫什么	金瓶梅
大鱼海棠的制作成本	海棠
乳腺结节的治疗方法	乳腺结节
后来的我们的导演资料	后来的我们
长征起始年份	长征
晓得microsoftofficeaccess是干啥的不	microsoftofficeaccess
金木研哪天出生的	金木研
爸爸去哪儿第四季的主持人么	爸爸去哪儿第四季
中二病的反义词	中二病
适宜葡萄生长的海拔是多少	葡萄
扭矩的数值	扭矩
银魂什么时候出版的	银魂
静夜思源自哪里	静夜思
林正英的原名	林正英
艾吉奥都有哪些后代	艾吉奥
巴黎圣母院建成的周期大概有多久	巴黎圣母院
163邮箱是干嘛使得	163邮箱
seo的诞生时间	seo
圣诞节是几月几号	圣诞节
三体的作品别名	三体
王牌逗王牌的对话语言是什么	王牌
十二星座的含义有哪些	十二星座
你看你看月亮的脸的发行公司	司
编出威风堂堂曲子的人是谁	威风堂堂
画江湖之不良人的音乐人是哪位	画江湖之不良人
王思聪他老爸是哪个	王思聪
圣诞节在哪天么	圣诞节
巴霍巴利王制作成本需要多少	巴利
团歌的曲作者	者
什么叫鬼畜	鬼畜
曹操的封号	曹操
老九门的其他翻译方式	老九门
三里屯的开放时间有多长	三里屯
英雄联盟的游戏属性是什么	英雄联盟
秘鲁用的那个时区什么名字	秘鲁
网页的拼音	网页
正态分布由谁发现的	正态分布
公主头属于什么	公主头
人民日报什么时候开始创刊的	人民日报
金毛寻回犬一般多高	寻回犬
哈利·波特叫什么	哈利·波特
老友记主题曲歌名是什么	老友记
纳兰性德的字号	纳兰性德
腰椎间盘突出症是哪里发病	腰椎间盘突出症
磁力链接是什么领域用的	磁力链接
想去瓜德尔港需要到哪个城市	瓜德尔
刘邦死的时间是	刘邦
国际歌的音乐风格是什么	国际歌
乌冬面最好吃的做法是/	乌冬面
维生素c开始融化时的温度	维生素c
蒲笋都是用什么做出来的	蒲笋
上海迪士尼乐园的气候类型	上海迪士尼乐园
哈利·波特的书叫什么	哈利·波特
海绵宝宝还有其他译名	海绵宝宝
神舟十一号飞船从何地发射的	神舟十一号飞船
北京故宫有多大	北京故宫
国歌的音乐曲风	国歌
原来你还在这里的台词是哪种语言	原来你
赵雷是什么类型的歌手	赵雷
诸葛亮卒于何时	诸葛亮
苏小妹的父亲	苏小妹
matlab是什么缩写来的	matlab
sumif函数的表达式	sumif函数
诛仙有哪些主角儿	诛仙
郑州的著名人物	郑州
周杰伦的床边故事专辑是哪种语言	床边故事
挂历的原型是什么	挂历
张国荣跨越97演唱会发行公司是什么名字	张国荣跨越97演唱会
谁管波风水门叫爸爸	风水门
幻城大约什么时候播出的	幻城
老舍的名字有哪些	老舍
关于郑州的记忆是谁在打鼓	关于郑州的记忆
巴厘岛的交流用语	巴厘岛
亲爱的，公主病首播是哪天	亲爱的
林允儿的血型是什么类型的	林允儿
奔跑吧兄弟的录音师是谁	奔跑吧兄弟
acl通过什么原则完成的	acl
名侦探柯南剧场版谁画的	名侦探柯南剧场版
1989的播放时间有多长	1989
提起哪句话会想到58同城	58同城
转义字符又称	转义字符
windowspowershell的平台是什么	windowspowershell
西伯利亚雪橇犬的族群是什么	西伯利亚雪橇犬
张若昀经典音乐作品	张若昀
四个全面最初是谁的想法	四个全面
iphone7里的程序叫什么名字	iphone7
什么也叫做幻灯片	幻灯片
在什么地方流行着农历	农历
引号的意义	引号
哪有百度糯米	百度糯米
谁是杀生丸爱人	杀生丸
杨绛的女儿叫什么	杨绛
碳酸氢钠标准的密度是多少	碳酸氢钠
赵雅淇的三围是	赵雅淇
node.js发布时间	node.js
王牌逗王牌的对白种类	王牌
歌诗达邮轮给人一种什么感觉	歌诗达邮轮
现在法国谁是总统	法国
东南亚国家联盟所有的面积	东南亚国家联盟
种葡萄的话海拔大概在多高	葡萄
看到哪些代码就知道是来自青岛的了	青岛
哪些原因会导致半月板生病	半月板
边境牧羊犬的性格好	边境牧羊犬
spring运行的应用是什么吗？通常spring可以在哪些范围内进行运行	spring
田雨橙亲弟是	田雨橙
怎么能找到rename	rename
如何评价舒淇	舒淇
银魂发行的时间段	银魂
windows10是由谁发行的	windows10
牛排的味道	牛排
维生素c在几度的时候会化掉	维生素c
网易公司股票代码是什么	网易公司
亚洲足球锦标赛的举办是在哪里	亚洲足球
荨麻疹的常见发病部位是哪里	荨麻疹
萨尔的坐骑名字叫	萨尔
蒲笋的食材清单	蒲笋
林俊杰信仰什么宗教	林俊杰
李世民的庙号	李世民
骁龙820的生产商	骁龙820
如果蜗牛有爱情在国际上用什么来代表	如果蜗牛有爱情
日产gt-r生产商是谁	日产gt-r
哪些事情是张国荣的兴趣爱好	张国荣
林允签的经济公司是哪个	林允
威尼斯有哪些与众不同的特产	威尼斯
胰岛素有哪些分子式	胰岛素
搜索引擎如何分类	搜索引擎
你能给我讲讲pdca循环不	pdca循环
关于阿特拉斯的故事	阿特拉斯
迈克尔·乔丹的儿子都叫什么	迈克尔·乔丹
蒋雯丽的丈夫叫什么	蒋雯丽
西游记是哪类体裁的小说	西游记
123算什么	123
御坂美琴的技能	御坂美琴
丑八怪属于哪个专辑	丑八怪
大学之道的意思	大学之道
都有谁是武动乾坤的主要人物	武动乾坤
深圳地铁的开通日	深圳地铁
纽约中央公园占有了多少地	纽约中央公园
谁是神奇动物在哪里的作者	神奇动物在哪里
那个做了上古卷轴5的人叫什么	上古卷轴5
北魏时期有多少人	北魏
慈溪的陵墓在哪儿	慈溪
贝加尔湖的深度是多少	贝加尔湖
月球的离心率	月球
王家卫的家属都有谁	王家卫
向日葵有哪些特征	向日葵
乌冬面的烹饪方法是什么	乌冬面
酉阳杂俎是哪个朝代的	酉阳杂俎
哪个是王思聪他爹不	王思聪
杭州的范围	杭州
bigbang是什么国家的	bigbang
sktelecomt1队名的英文叫什么	elecom
景行厅男孩的专辑曲目有哪些	景行厅男孩
沈腾的姐姐是谁	沈腾
谁是猪八戒的扮演者	猪八戒
比亚迪唐的首发时间	比亚迪唐
唐纳德·特朗普信仰什么	唐纳德·特朗普
绝命毒师获得奖项有哪些	绝命毒师
timbaland的音乐厂牌	timbaland
梅毒的传播途径	梅毒
timbaland加入哪个音乐厂牌	timbaland
谁给我说下参商谁唱的	参商
svchost.exe的服务商是哪家	svchost.exe
谁娶了三毛	三毛
玉器鉴别有几种方法	玉器鉴别
提起五月天大家就会想到哪些作品	五月天
林允儿血型	林允儿
毛泽东是在哪天逝世的	毛泽东
哪家公司推出来了美元的	出来
青岛市工商行政管理局的办公地点	青岛市工商行政管理局
毛泽东过逝的日子是哪天	毛泽东
国际空间站的重量有多少	国际空间站
中国好声音第五季是个什么类的节目	中国好声音第五季
雪儿的曲风	雪儿
蓝光的应用领域	蓝光
罗永浩生于哪天	罗永浩
有点儿意思mv导演介绍	mv
地球有多重	地球
硫化氢有没有毒	硫化氢
李白本名	李白
宋江弟弟的名字	宋江
内战的预兆的创作年份是什么	内战的预兆
卢旺达种族大屠杀的死伤人数	卢旺达种族大屠杀
秦始皇的逝世年龄是多大	秦始皇
花千骨师从于谁	花千骨
举几个des的类型	des
三味线在哪张专辑	三味线
一拳超人谁出的	一拳超人
杜鹃什么能力比较突出	杜鹃
老司机带带我的原唱	老司机带带我
strstr的介绍	strstr
带颞的词有哪些	些
名侦探柯南播到哪集了	名侦探柯南
林夕祖辈是哪的	林夕
王健林他妈叫什么	王健林
哪年滨崎里绪出道了	滨崎里绪
身体乳是什么	身体乳
咱们相爱吧什么时候生产的	相爱
加拿大的官方语言是什么	加拿大
天龙八部谁出的	天龙八部
蓝光的所属领域是什么	蓝光
唯品会的语言种类	唯品会
上海迪士尼乐园的气候是什么样的	上海迪士尼乐园
一只金毛寻回犬正常应该要有多高	寻回犬
acl的原则	acl
联想集团是哪个国家的企业	联想集团
章泽天的男友	章泽天
webdav的基本条件是	webdav
林志颖的母亲叫什么	林志颖
章鱼哥朋友	章鱼哥
星座的起源	星座
qq邮箱如何用外语说	qq邮箱
人民日报什么时候开始刊行的	人民日报
3d打印发明人	3d
ncbi是什么国的	ncbi
赵雷的流派是怎样的	赵雷
汤圆有哪些好吃的做法	汤圆
田雨橙弟弟的名字	田雨橙
民族乐派是什么时候的	民族乐派
美国属于哪个大洲	美国
秋葵名称从哪来	秋葵
黑色星期五是什么时候	黑色星期五
ppp的分类么	ppp
大学问的作曲人	大学问
蒙面唱将猜猜猜这个节目的录制地区是在哪里	猜猜猜
崔健的音乐厂牌是哪家	崔健
你懂黑洞直径不	黑洞
颐和园什么时候开门关门	颐和园
引号的作用	引号
i来源于拉丁文里面第几个字母	i
区块链的特质	区块链
1989的播放时长有多长	1989
痰的重要组成部分是什么	痰
核心期刊的核心理论是什么	核心期刊
哪个平台播灵魂摆渡3	灵魂摆渡
幻城的放映时间	幻城
饕餮最早的意思是什么	饕餮
哪个人写的跳蚤之歌	跳蚤之歌
甘肃的特产	甘肃
关之琳的好友	关之琳
抖s的对义词	抖s
数据结构是干嘛的	数据结构
比亚迪股份有限公司一共有多大的面积么	比亚迪股份有限公司
怎么去百度糯米	百度糯米
菲德尔·卡斯特罗的生日是几月几号	菲德尔·卡斯特罗
r语言的功能	r语言
荷兰的国家代码	荷兰
intelskylake的品牌名字	intelskylake
深圳的所在区域	深圳
谁写的神奇动物在哪里	神奇动物
哪个国家出的bigbang	bigbang
怎样的颜色是他是龙的色彩	龙
梁非凡挂念的人	梁非凡
李嘉诚的夫人	李嘉诚
爱奇艺用英语咋说	爱奇艺
幻城的上映日期	幻城
缘之空的发行公司	缘之空
王嘉尔都有哪些亲属	王嘉尔
泰勒·斯威夫特什么时候开启了自己的舞台生涯	泰勒·斯威夫特
贝拉克·奥巴马老婆是哪位	贝拉克·奥巴马
淘宝网具体的成立时间	淘宝网
谁是团歌的曲作者	团歌的曲作者
哪个是荷兰的国家代码	荷兰
中国传统节日在哪里广泛流行	中国传统节日
第一次世界大战该怎么说	第一次世界大战
团歌的作曲	歌
人查字的四角号码	查
怎么用中文说西部世界	西部世界
石进最近住在哪座城市	石进
捉鬼记的歌曲别名叫什么	捉鬼记
现代简约风格源自什么学派	现代简约风格
周杰伦的床边故事专辑的歌曲语言是什么	床边故事
哪个公司出产的jira	jira
重庆北站南广场算是什么级别的火车站	重庆北站
i来源于拉丁文里面第几个字母	i
像是中国好声音第五季这种节目形式是属于什么类的	中国好声音第五季
北京四环路的具体位置	北京四环路
五位一体是不是出自于十八大报告	五位一体
怎么应用springmvc	springmvc
天津的地方语言	天津
原来你还在这里的台词是哪国话	原来你
沙溢在哪儿出生的	沙溢
巴黎信奉什么宗教的	信奉
flowerdance在哪张专辑里	flowerdance
姚明的姑娘叫什么名字	姚明
strstr什么意思	strstr
聚丙烯的化学式	聚丙烯
美国的所属大洲	美国
玻璃的分子结构是什么	玻璃
郑州有哪些名人	郑州
拉斯维加斯的建成时间是哪一年	拉斯维加斯
打羽毛球都能去哪里	羽毛球
杜鹃有什么本事	杜鹃
哪里是中央电视台的区域	中央电视台
完美世界的出版机构	完美世界
刘亦菲又叫什么	刘亦菲
搜复旦大学会出现什么样的详细信息	复旦大学
蔡依林的专辑销量	蔡依林
社会保险有什么帮助	社会保险
武动乾坤有哪些主要人物	武动乾坤
怎么做冰点脱毛	冰点脱毛
acfun的宣传口号是什么	acfun
合成蜂蜜	合成
qq最近版时间是	qq
在旧金山都用什么时区	旧金山
哪种动物深得柳岩的欢心	柳岩
拾穗者什么时候去世的	拾穗者
戚继光典故	戚继光
六味地黄丸是干嘛用的	六味地黄丸
百度云在中国怎么说	百度云
bigbang不	bigbang
厦门方言是什么	厦门
iphone6都有什么颜色的	iphone6
非洲的本意	非洲
latex归属于什么	latex
二战爆发于哪些国家	些
罗永浩是哪年生的	罗永浩
鹿晗的国籍是	鹿晗
yy语音的老板	yy语音
谍影重重的级别是什么	谍影重重
金木研的生日是几月几号	金木研
巴黎圣母院用了多久建造出来的	巴黎圣母院
三极管是什么材料做的	三极管
192.168.1.1的分类是什么	192.168.1.1
萨尔的坐骑是什么	萨尔
巴黎圣母院修了多长时间	巴黎圣母院
tfboys的出生地么	tfboys
啥时候出现的潘金莲	潘金莲
疯狂动物城的imdb编码是什么	动物城
张若昀经典音乐作品有哪首	张若昀
什么叫蓝牙	蓝牙
萌萌哒天团建立时间	萌萌哒天团
孙悟空源自哪里	孙悟空
蔡国庆的单位	蔡国庆
哪个宗教是林心如信仰的	林心如
丑八怪是从哪个专辑里出来的	丑八怪
谁是城寨英雄中拍摄中的灵魂人物	灵魂人物
cvt有哪种工作原理	cvt
乔任梁啥星座	乔任梁
谁做的上古卷轴5	上古卷轴5
关于ba的原子量你知道具体的数	ba
玉器鉴别的方法	玉器鉴别
谁是团歌的作曲	歌
5·12汶川地震的名称不	5·12汶川地震
济南有哪些特产	济南
秋田犬一般原产地在哪里的	秋田犬
g20峰会产生于哪年	g20峰会
范冰冰的血型	范冰冰
幻城的上映时间	幻城
中央电视台在什么地方	中央电视台
圆明园的门票定价	圆明园
金牛座是几月份出生的	金牛座
163邮箱是干什么的	163邮箱
谁负责雍正王朝的日常运作策划	雍正王朝
长征哪年开始的	长征
酷儿身高体重	酷儿
1的汉语拼音怎么拼	1
苹果的益处	苹果
放些什么东西做出来的才算担仔面	担仔面
希尔薇今年多大	希尔
贞操带什么时期流行	贞操带
谁写的词用于奇妙能力歌啦	奇妙能力歌
表面粗糙度的成因	表面粗糙度
iphone7的操作系统	iphone7
无题是哪种文体类别	无题
ssid的专长在哪	ssid
生死狙击的内容主题	生死狙击
web的内涵	web
玉皇大帝住哪	玉皇大帝
雪儿的音乐是什么风格	雪儿
薛之谦的大学	薛之谦
什么系统里带services.msc	services.msc
精灵宝可梦的作者叫什么	精灵宝可梦
网盘的技术关键	网盘
识汝不识丁的风格	识汝不识丁
123不	123
给我解释下狗带	狗
蔡依林的唱片销量	蔡依林
什么活动定于盂兰盆节内	盂兰盆节
择天记首次发布是在哪个网	择天记
梅兰芳的民族族群是什么	梅兰芳
写色情小说的要求	色情小说
月球的离心率是多少	月球
亚洲足球锦标赛在哪里举办	亚洲足球
王牌逗王牌的对话种类是什么	王牌
原纱央莉叫什么	原纱央莉
风信子的花语	风信子
宋智孝的属相	宋智孝
章泽天的恋爱对象	章泽天
新加坡的英文表达	新加坡
公主头是什么风格的	公主头
acl的原则是什么	acl
谁写出来的曲子命名为欢乐颂了	欢乐颂
澳门人口有多少么	澳门
中国好声音第五季是哪类的节目	中国好声音第五季
摩尔斯电码是谁发明的	摩尔斯电码
淘宝旺铺的创始人是谁	淘宝旺铺
大熊猫是哪个门类下的	大熊猫
we角逐的赛事是什么	we
ba钡元素的原子量数值是多少	ba
歼-20是哪个国家的	歼-20
哪个是香港的电话区号	香港
甘雅丹的唱歌特点是什么	甘雅丹
颞有什么词语	颞
为什么都用千图网	千图网
冰点脱毛的原理	冰点脱毛
刘亦菲还叫什么	刘亦菲
像是滕王阁序这类作品大家都称其为什么	滕王阁序
唱参商的那个人	参商
随便说几个合肥的大学	合肥
哪个专辑里有丑八怪的	丑八怪
贾云馨的粉丝有什么组织	贾云馨
知网是什么样	知网
黄家驹弟弟是哪位	黄家驹
蓝光的所属领域	蓝光
梦想的声音多会儿才能播	多会
呼斯楞的唱歌特点	呼斯楞
hyper-v的公司	hyper-v
僵尸会在哪里出现	僵尸
ssid用于什么	ssid
microsoftonenote现在处于什么阶段	microsoftonenote
五证合一的近义词	合一
汞的相对原子质量告诉我一下	汞
阴茎存在于哪	阴茎
哪个词和书信相反	书信
seeyouagain制作	seeyou
滕王阁序能代表什么体裁的文学	滕王阁序
萨尔的坐骑叫什么	萨尔
什么时候成立了nba	nba
柏拉图老师的名字	柏拉图
ppap用的什么中文名字	ppap
还有哪些跟新闻有关的词语	词语
亮剑的颜色	亮剑
精灵梦叶罗丽第四季有几集	精灵梦叶罗丽
对数的发明者	对数
美丽的神话的音乐版权	美丽的神话
青岛市工商行政管理局的办公场地	青岛市工商行政管理局
章泽天的爱人是谁	章泽天
5·12汶川地震叫什么名字	5·12汶川地震
侠盗猎车手5是哪个系列的作品	侠盗猎车手5
世界博览会不同门票的票价分别是	世界博览会
新闻的同义词你知道几个	新闻
pdca循环指什么	pdca循环
谁的专辑名是自传	谁
洛杉矶有哪些火车站	洛杉矶
中国知网的官方网址	中国知网
哪项大奖被绝命毒师抱走了	绝命毒师
龚琳娜跟谁结婚了	龚琳娜
林丹是哪个运动项目的代表人物	林丹
张国荣跨越97演唱会的唱片发行商	张国荣跨越97演唱会
谁是冰菓的制片	冰菓
大熊猫是什么门类的	大熊猫
年轮说全部曲目数量	年轮
章泽天的男朋友	章泽天
资本在字典上的意思	资本
r语言的作用	r语言
杜鹃所会的	杜鹃
长城地处什么位置	长城
任天堂的邮递区号	任天堂
flowerdance收录在哪张专辑里	flowerdance
联想集团的国名	联想集团
伊利诺伊大学厄巴纳-香槟分校的学校类型是什么	伊利诺伊大学厄巴纳-香槟分校
联想集团属于哪个国家	联想集团
杀生丸爱人有哪些	杀生丸
mindgeek的研发中心是哪个公司	geek
ptc由哪些物质组成	ptc
木心给谁传授过知识	木心
bobbytinsley的音乐流派	bobbytinsley
山东火车站	车站
猫来自哪个纲	猫
上海虹桥国际机场总共多大的建筑面积	上海虹桥国际机场
艾吉奥是谁的祖先	艾吉奥
王牌逗王牌的对白语言	王牌
自然常数有哪些公式	自然常数
贵金属有哪些做法	贵金属
蒙面唱将猜猜猜这个节目的录制地区	猜猜猜
那个开发了unity3d的公司叫什么	unity3d
跟堺雅人在一起的那个人叫什么	堺雅人
三七粉的好处	三七粉
希拉里·黛安·罗德姆·克林顿的学历	希拉里·黛安·罗德姆·克林顿
我们的少年时代在哪个台播	少年时代
操作系统里都有什么	操作系
cvt的工作方法	cvt
灵魂摆渡人的原曲是哪首	灵魂摆渡
民族乐派是哪个年代的	民族乐派
无花果是哪个门类	无花果
对数函数的特征	对数函数
乔任梁的星座	乔任梁
范冰冰的血	范冰冰
什么时候有的新三板	新三板
比特币是什么样的货币	比特币
吉尔伽美什的称呼是什么	吉尔伽美什
内科有哪些治疗手段	内科
沙溢的出生地	沙溢
一加手机的显示屏具体多大	一加手机
转义字符还有什么叫法	转义字符
宇宙直径	宇宙
林允的公司	林允
朴槿惠婚否	朴槿惠
用英语说万圣节	万圣节
做担仔面要有什么东西	担仔面
青岛市工商行政管理局的办公地点	青岛市工商行政管理局
都哪里发行了走向共和	走向共和
百合的类别	百合
做拉面的方法	拉面
谁唱的参商么	参商
内科的医疗方法	内科
聚氯乙烯的颜色	聚氯乙烯
有哪些名人在南通	南通
灵魂摆渡人的原曲	灵魂摆渡
陈绮贞的音乐类型是什么	陈绮贞
包皮的属性分类	包皮
甄嬛恋人	甄嬛
谁唱的lemontree	lemontree
几个有关新闻的词语	有关
bose总部位置	bose
马来西亚的著名城市	马来西亚
那些花儿有哪些歌手唱过	那些花儿
哪种风情是歌诗达邮轮所具备的	歌诗达邮轮
哪些人是属于艾吉奥的后代的	艾吉奥
kenarai早期作品	kenarai
牛排的味道	牛排
网这个字一共多少画	网
官方发行python是在什么时候	python
在哪一天毛泽东身故的	哪一天
那个cp的来源是怎样的	cp
乔任梁的星座	乔任梁
张国荣对什么感兴趣	张国荣
蔡依林的专辑销量达到了多少	蔡依林
thebeatles的音乐风格	thebeatles
ds的油耗量	ds
刘贺的陵墓	刘贺
运动员董力是哪个队的	运动员
还可以叫刘亦菲什么	刘亦菲
曹操的谥号叫什么	曹操
哪些症状是抑郁症的表现	抑郁症
月球的离心率大概是多少	月球
劳尔·卡斯特罗的亲哥是哪位	劳尔·卡斯特罗
李小龙的子女有哪些	李小龙
青春的含义	青春
哪个时间段会放妖精的尾巴	时
晓得中国知网的网址不	中国知网
什么公司制作了十二道锋味第二季的	十二道锋味
绝命毒师拿的那个是什么奖	绝命毒师
用拼音表示一下1的读法	1
孔子的原名	孔子
陪你度过漫长岁月是什么歌曲语言	陪你
澳大利亚主要城市有哪些	澳大利亚
原版的东京食尸鬼叫啥	东京食尸鬼
白冰什么方面最突出	白冰
bootstrap的类型为何	bootstrap
下载辐射避难所的软件有哪些	避难所
罗永浩生于哪年	罗永浩
张艺兴的那个团队叫什么	张艺兴
演员的外语	演员
长沙的大学介绍	长沙
城寨英雄的监制	英雄
诛仙的主角儿叫什么	诛仙
劳尔·卡斯特罗的兄长是谁	劳尔·卡斯特罗
模特的作词人叫什么	模特
北京的地理位置	北京
大数据的提出者是谁	大数据
吴亦凡有多重	吴亦凡
三极管材料包括哪些材料	三极管
des的类型	des
mindgeek属于哪个团队	geek
古剑奇谭监制人的名字	古剑奇谭
哪位是腾讯的老板	腾讯
3d肉蒲团之极乐宝鉴的出品人是谁	3d肉蒲团之极乐宝鉴
facebook的公司性质	facebook
能播放流媒体的那个叫什么名字	流媒体
亚洲足球锦标赛的举办地点是在哪里	亚洲足球
node.js的发布日期	node.js
007经典饮食习惯是什么	饮食习惯
网总笔画是多少	网
王牌逗王牌的对话种类	王牌
ip地址分几类	ip
六西格玛的内容	六西格玛
美人鱼的名字有哪些	美人鱼
新金瓶梅是什么类的	新金瓶梅
动漫是什么	动漫
可以给告诉我月球的离心率是多少	月球
那个写出铳皇无尽的法夫纳的人什么名字	铳皇无尽的法夫纳
哪些作品是王维最具代表性的	王维
杨洋身高是多少	杨洋
为冰菓筹钱的是谁	冰菓
陈思诚的生肖	陈思诚
有谁饰演过猪八戒	猪八戒
加拿大人的语系是什么	加拿大人
杨永信是男的么	杨永信
大鱼海棠电影成本	海棠
谁在当惠普的董事长	惠普
microsoftoffice的最新版本叫什么	microsoftoffice
一人我饮酒醉能唱多久	一人
赵冀龙身高体重分别是多少	赵冀龙
克里斯汀·斯图尔特的主要血统	克里斯汀·斯图尔特
bose公司地址	bose
张宇是谁门下的	张宇
空气质量指数被划分了哪个几个级别	空气质量指数
帝霸现在什么状态	帝霸
赵云的朝代是	赵云
加利福尼亚州必去景点有哪些	加利福尼亚州
提起什么称号大家会想到李昌钰	李昌钰
白夜行的文学体裁是什么	白夜行
月球的离心率你知道是多少	月球
spring的应用范围	spring
赵雅淇的三围	赵雅淇
李小龙都有哪些孩子	李小龙
奇门遁甲被称为什么	奇门遁甲
幽门螺杆菌属于什么界的	幽门螺杆菌
python在哪年与我们见面的	python
深圳的区域划分	深圳
锦绣未央是哪本小说改编的	锦绣未央
刘亦菲有什么小名	刘亦菲
什么地方提到了smart原则	smart原则
刘亦菲有哪些称呼	刘亦菲
当归是哪个种的	当归
是哪个厂商出品了守望先锋的	守望先锋
玉米的原唱是谁	玉米
我的奇妙男友由谁创作的	男友
犬儒主义讲的是什么	犬儒主义
自然常数的运算法则是什么	自然常数
怎么使用sleep函数	sleep函数
杨洋长得有多高	杨洋
北京故宫面积是	北京故宫
借记卡如何正确使用	借记卡
网盘应用了哪些技术	网盘
法国现任总统叫什么名字	法国
第一次世界大战叫什么	第一次世界大战
黄山是几a级景点	黄山
黑羽的英语名	黑羽
血液透析可以治疗的疾病是	血液透析
现代简约风格的起源	现代简约风格
第一次排版印刷斗罗大陆是在什么时候	斗罗大陆
王健林是谁的儿子	王健林
哪些国家曾经历二战	些
琅琊榜什么时候开播的	琅琊榜
血红蛋白的成分是啥	血红蛋白
桃谷绘里香哪个星座的	桃谷绘里香
极乐净土外语怎么说	极乐净土
侠盗猎车手5是什么的衍生系列	侠盗猎车手5
操作系统都涵盖哪些	操作系统
东南亚可以缩写成什么	东南亚
牛排有什么味道的	牛排
谁是唐舞麟的妈妈	唐舞
什么的简化是matlab	matlab
六味地黄丸的功效	六味地黄丸
裴秀智通过什么运动减肥	裴秀智
大鱼海棠电影投资成本多少	海棠
毛泽东是在哪天离开我们的	毛泽东
燕麦有没有毒	燕麦
哪个国家有ncbi	ncbi
王莽年号都有什么	王莽
w-inds.担任主唱的那个是谁	w-inds.
血红蛋白的组成	血红蛋白
用机械键盘的优势是什么	机械键盘
萌萌哒天团开创地点	萌萌哒天团
生死狙击玩家人数规定	生死狙击
苹果的ceo是谁	苹果
易烊千玺哪个星座	易烊千玺
谁生产的unity3d	unity3d
蒋雯丽的爱人	蒋雯丽
南通的名人具体有哪几个	南通
播妖精的尾巴的都是什么时候	妖精的尾巴
刘慈欣的职位是什么	刘慈欣
杨洋的身高	杨洋
亚洲还可以怎么叫	亚洲
帮我给颞组个词	词
宁夏的大学	宁夏
国歌的曲风是什么	国歌
乔任梁的星座是啥	乔任梁
bilibili的奠基人	bilibili
qq邮箱的外文如何说	qq邮箱
上海虹桥站的车站级别是什么	上海虹桥站
蒙奇.d.路飞的配音演员是谁	蒙奇
木村拓哉为什么能出名	木村拓哉
cp的来源是什么	cp
首届g20峰会是哪年	g20峰会
南京地铁哪天开始有的三号线	南京地铁
还可以用哪些词语形容二八定律	二八定律
未央宫多大建筑面积	未央宫
切·格瓦拉与谁是夫妻	切·格瓦拉
劳尔·卡斯特罗的亲哥是谁	劳尔·卡斯特罗
身体乳	身体乳
adobeillustrator何时与我们初次见面的	adobeillustrator
什么时候开始建设的天安门	天安门
林丹是做什么运动的	林丹
你懂fyi的意思么	fyi
罗永浩的出生日期	罗永浩
猫咪老师看上去像是个什么	猫咪老师
大熊猫属于哪个门类	大熊猫
五四运动影响了什么	五四运动
巴西的主要宗教	巴西
投名状花了多少成本拍摄的	投名状
在哪里可以看到亚洲足球锦标赛的举办	亚洲足球
上古卷轴5经由谁的手作出的	上古卷轴5
麻生希最爱干些什么事情	麻生希
立体电影是什么电影	立体电影
一人我饮酒醉曲子的长度	一人
是谁给伊丽莎白谱的曲	伊丽莎白
拉斯维加斯是多会儿建立的	拉斯维加斯
悦的读音	悦
张国焘在哪里逝世的	张国焘
农历在哪些圈子流行	农历
喝拿铁对人有什么害处	拿铁
吴亦凡的体重	吴亦凡
qq邮箱英文名是啥	qq邮箱
宋朝君王是	宋朝
t是谁的	t
王健林的妈妈是谁	王健林
可见光的平均速度	可见光
任天堂的具体邮编	任天堂
哪些人创办的windows操作系统	windows操作系统
在什么时期流行贞操带	贞操带
facebook是什么单位性质的公司	facebook
老友记主题曲叫什么	老友记
天猫的本名是	天猫
提出四个全面的叫什么	叫什么
哪些名人是麻省理工学院大学的校友	麻省理工学院
vlookup函数是干啥的	vlookup函数
还有什么词语可以替代新闻	还有什么
张起灵的祖父是谁	张起灵
极限挑战什么时候播出	极限挑战
极乐净土用罗马音怎么拼	极乐净土
都有哪些好玩的地方在安徽	安徽
辛亥革命的主导人物	辛亥革命
咱们相爱吧啥时候做出来的	相爱
加拿大人的语言种类是什么	加拿大人
听一人我饮酒醉需要多久	一人
3d打印发明人是谁	3d
3d肉蒲团之极乐宝鉴这部片子的投资人是谁	3d肉蒲团之极乐宝鉴
秘鲁用的是哪种时区	秘鲁
什么时候设立的元旦	元旦
啥时候高桥李依进的娱乐圈	李依
北京南站的上级单位是哪里	北京南站
volte指什么	volte
开化大酒店总层数是多少	开化大酒店
nba成立的时间	nba
釜山行的英语么	釜山行
深圳地铁11号线的开通时间是什么时候	深圳地铁11号线
宋仲基的粉丝怎么称呼	宋仲基
提起林丹想到的是什么运动	林丹
种植葡萄的地方一般海拔有多高	葡萄
哪年有的计算机	计算机
长征从开始到结束	长征
神吕布有什么好的能力	神吕布
孤独的英语名字是	孤独
谁是bigbang	bigbang
资产负债表干嘛用的	资产负债表
郑州的名人	郑州
微微一笑很倾城的色彩	微微一笑很倾城
天龙八部总制片人	天龙八部
神奇动物在哪里的作者叫什么	神奇动物在哪里
印度的总人口	印度
梅毒的传播途径是什么	梅毒
哪些高等院校在佛山	佛山
朴槿惠结婚了	朴槿惠
c语言的前身	c语言
是谁发现了正态分布的	正态分布
谁是杨绛的闺女	杨绛
长白山脉的正峰	长白山脉
生物学中幽门螺杆菌属于什么界	幽门螺杆菌
谁演唱的玉米	玉米
磁力链接的应用领域	磁力链接
如何用英语念黑羽	黑羽
爸爸去哪儿第四季谁主持的不	爸爸去哪儿第四季
必应是什么	必应
荨麻疹一般从哪些部位开始的	荨麻疹
贝加尔湖的深度达到了多少米	贝加尔湖
咱们相爱吧与我们见面的时间	相爱
老舍别的名字叫什么	老舍
六法论是什么里的	六法论
澳大利亚有哪些主要城市	澳大利亚
rename在计算机哪个位置	rename
滨崎里绪什么时候开启了自己的舞台生涯	滨崎里绪
比特币属于什么	比特币
派俊伟的老师	俊伟
英文简历的模式	英文简历
北京的所属地区	北京
大熊猫的门类你懂不	大熊猫
英文名的举例	英文名
中国历史朝代是怎样的政治体制	中国历史朝代
周二珂的工作是什么	珂
老炮儿的门票收入是多少	老炮儿
哪个国家有蒙面唱将猜猜猜这个节目	猜猜猜
什么是互联网吧	互联网
中国国家女子排球队的外文名字	中国国家女子排球队
比利时用什么花当国花	比利时
老舍的名字分别有哪些	老舍
小说帝霸进行到哪了	小说
伊利诺伊大学厄巴纳-香槟分校是个怎样的学校	伊利诺伊大学厄巴纳-香槟分校
迪拜的国土是多少	迪拜
springmvc的应用模式	springmvc
伏地魔的岁数	伏地魔
神舟十一号飞船发射于哪里	神舟十一号飞船
喝拿铁有什么副作用	拿铁
w-两个世界首播时间	播
哪位监制人负责的古剑奇谭	哪位监制人
中国好歌曲的节目种类	中国好歌曲
facebook这个公司是什么类别的	facebook
董力在哪个队服役	董力
国王与乞丐录音是谁	王与
微软有哪些重要的产品	微软
步步惊心：丽的其他叫法	步步惊心
谁是斯卡哈的学生	斯卡哈
塞浦路斯的英文表达是什么	塞浦路斯
麻生希的兴趣点在哪些事情上	麻生希
研究员做什么工作	研究员
蓝色大海的传说用中文怎么说	大海的传说
多少国家在用iso9001	iso9001
味噌汤具体要怎样做	味噌汤
唐人街探案谁出的	唐人街
金毛寻回犬的高度	寻回犬
windows10发行公司的具体名字	windows10
李相赫的外号叫什么	李相
都怎么去得出扭矩的数值的	扭矩
张国荣有什么兴趣爱好	张国荣
名侦探柯南出到多少集了	名侦探柯南
中南海的定位是哪儿	中南海
哪些人被称为民国四大美男	民国四大美男
歼-20被哪个国家所有	歼-20
关于新闻的词语有哪些	于新
北京南站的上级部门是哪里	北京南站
杀生丸爱人叫什么	杀生丸
用多少钱拍了投名状	用多少钱拍
小动物柳岩都喜欢什么	动物
faded的原唱是谁	fad
华山东西跨度是多少	华山
谁演过赵敏	赵敏
网页用什么拼音去表示	网页
七月与安生的书名么	七月与安生
唐三女儿的丈夫是谁	女儿
unity3d的开发公司	unity3d
appletv价格	appletv
百度糯米的办公地点	百度糯米
禁止的爱是哪个国家播的	播
心脏搭桥手术的病因是什么	心脏搭桥手术
latex是什么的重要部分	latex
神奇动物在哪里是谁写的	神奇动物
刘慈欣当初到底是什么身份	刘慈欣
那个师从木心的叫什么	木心
民族乐派出现的年代	民族乐派
华东师范大学的位置	华东师范大学
追梦赤子心揽下了什么奖项	追梦赤子心
腾讯老板是哪个	腾讯
博柏利努力成为什么样的品牌	博柏利
1024这天是啥节日	1024
辞职信主要结构是什么	辞职信
饥荒的创作者是谁	饥荒
组策略的应用领域	组策略
王家卫的家庭成员	王家卫
梁经伦是谁的学生	是谁
六西格玛的意思	六西格玛
秦始皇在世多少年	秦始皇
伊万卡·特朗普的另一半	伊万卡·特朗普
澳门有多少人	澳门
匆匆是哪年出版的	匆匆
张国荣跨越97演唱会的唱片发行商是哪家	张国荣跨越97演唱会
张国荣的爱好是啥	张国荣
谁是惠普的董事长	惠普
一般色情小说都有什么要求	色情小说
i的起源是哪儿	i
中国历史朝代的政治体制是什么	中国历史朝代
microsoftonenote现在的发行状态是怎样的	microsoftonenote
宁夏的高等院校	宁夏
we现在角逐什么赛事	we
啥样的药是维生素a	样
奇门遁甲以什么名而著称	奇门遁甲
鬼畜什么意思	鬼畜
路西法是什么故事里的	路西法
windowspowershell在哪个平台	windowspowershell
最后的问候的作词者和作曲者	最后的问候
慈禧的陵墓	慈禧
饥荒是由谁创作出来的	饥荒
数据库的概念	数据库
疯狂动物城的imdb编码是多少	动物城
孤独英译名	独英
websocket用来指代什么	websocket
s.t.的意思	s.t.
绘画需要由什么组成	绘画
美丽的春天歌手姓名叫	美丽的春天
猪八戒的饰演者	猪八戒
刘亦菲常常被人称为什么	刘亦菲
adobeillustrator在哪年与我们见面的	adobeillustrator
voc有什么样的危害	voc
介绍bootstrap的类型	bootstrap
安徽的著名景点	安徽
php的设计者	php
美丽新世界这个作品从哪出现的	美丽新世界
是哪个人把正态分布发现出来的	正态分布
给我用拼音拼一下网页	网页
中国地质大学的邮编	中国地质大学
我们的少年时代通过什么平台播放	少年时代
翻译下site	翻译
荷兰的国家代码是什么啊!	荷兰
吴亦凡有多沉	吴亦凡
赵匡胤的陵墓叫什么	赵匡胤
4399小游戏总部跟哪儿	4399小游戏
rename在计算机里面的位置吧	rename
hdmi的特性是什么	hdmi
红薯在哪些地方适宜生长	红薯
临江仙什么时候流行	临江仙
还有什么也是转义字符的意思	转义字符
c语言的起源	c语言
拿铁的副作用	拿铁
中国新歌声的主持人名单	新歌
哪种时区应用在秘鲁	秘鲁
吃苹果对身体有什么好处	身体
为奇妙能力歌作词的人叫什么	奇妙能力歌
创立富士康的人	富士康
运动鞋比普通的鞋好在哪里	运动鞋
蒙奇.d.路飞的配音是谁	蒙奇
鸡蛋果的生物类属	鸡蛋果
端午节的主食	端午节
tfboys的出生地你晓得不	tfboys
江苏的省会在哪儿	江苏
维生素a的外貌如何	维生素a
从你的全世界路过演了多长时间	从你的全世界路过
农业电子商务现在的状态	电子商务
羽毛球是在哪些场地能玩的	羽毛球
ebsco具体位置	ebsco
西伯利亚雪橇犬的种群	西伯利亚雪橇犬
从你的全世界路过从开始到结束需要多久	从你的全世界路过
百度百科哪个公司旗下的	百度百科
seo的诞生日期	seo
熔炉是谁的作品编的	熔炉
黄致列的代表作	表
清明上河图是哪年的	清明上河图
三七粉的功效	三七粉
pthread_cond_wait搭配什么好	pthread_cond_wait
锦绣未央的标价是	锦绣未央
蒙奇.d.路飞的配音演员是谁	蒙奇
angelababy的生肖	angelababy
需要多长时间能放完一人我饮酒醉	一人
maven的本质是什么	maven
pdca循环代表什么	pdca循环
卢旺达种族大屠杀的受害人数	卢旺达种族大屠杀
给我讲讲尊重的意思	尊重
香港的电话区号	香港
吴启华现在跟哪儿生活	吴启华
城寨英雄的监制叫什么名字	英雄
松花江的流域面积有多少	松花江
秋田犬发源地是哪里	秋田犬
玉米的原唱是	玉米
波雅·汉库克喜欢谁么	波雅·汉库克
讲解一下pmc的工作领域	pmc
老九门的其他翻译方式是什么	老九门
顺丰速运总公司在哪里成立	顺丰速运
汤圆怎么做出家常菜的味道	汤圆
甘雅丹的唱法	甘雅丹
张国荣喜欢干什么	张国荣
蔡国庆的工作单位	蔡国庆
你曾是少年是哪种类型的专辑	你曾是少年
五证合一还有哪些近义词	合一
幻灯片的另一个意思是什么	幻灯片
新西兰货币	新西兰
贝加尔湖到底有多深	贝加尔湖
qq音乐谁做的	qq音乐
方大同的演唱特点	方大同
姜思达在哪个学校毕业	姜思
李小龙的子女都有谁	李小龙
帝霸小说进度	小说
后来的我们mv是谁拍的	后来的我们
伏地魔活到多大	伏地魔
史蒂夫·乔布斯的母亲叫什么名字	史蒂夫·乔布斯
陈氏太极拳在哪个国家流传	陈氏太极拳
黄山是几a级旅游景点	黄山
塞卡病毒由什么感染的	病毒
蒙奇.d.路飞的配音演员是谁	蒙奇
在w-inds.中当主唱的那个男孩叫什么	w-inds.
缘之空的发行方	缘之空
苏联有过哪些领导人	苏联
关于碳酸氢钠的密度你知道数值	碳酸氢钠
哪些高等学校在海南	高等学校
内容分发网络有着怎样的基础	内容分发网络
太岁的组成	太岁
xamarin的发音	xamarin
黑羽的英文名	黑羽
有多少人是印度籍	印度
上海虹桥站的车站级别	上海虹桥站
惠普是谁的企业	惠普
甘雅丹的演唱风格	甘雅丹
芈月传是哪个导演不	芈月传
迈克尔·乔丹是谁的爸爸	迈克尔·乔丹
哪种动物是被柳岩喜欢的	柳岩
voc危害特征有什么	voc
百度注册的公司名字叫什么	注册
心理健康的表现	心理健康
用贵金属做的	贵金属
如何在车牌代码上显示出来自青岛	青岛
绝世唐门属于什么类的书	绝世唐门
核心期刊的理论基础是什么	核心期刊
静夜思的来源	静夜思
最后的问候的词曲	最后的问候
诸葛亮活到了哪天	诸葛亮
刘娜萍歌曲代表作有哪些	刘娜萍
妖精的尾巴在什么时候播放出来的	妖精的尾巴
机器学习涉及什么学科	机器学习
想去海南念大学能介绍一下都有哪些么	海南
位于海南的高校都有哪些	海南
李未央的妹妹是哪位	李未央
什么时候开始有的咱们相爱吧	相爱
mfc这种应用适合什么人使用	mfc
邓紫棋喜欢的食物是什么	邓紫棋
如何服用b族维生素	b族维生素
悦的拼音	悦
火影忍者在哪诞生	火影忍者
谁拍的有点儿意思mv	mv
灵能百分百的连载网站	灵能百分百
曹操被称为什么	曹操
啥时候丢番图谢世的	丢番图
语音是由什么发出来的	语音
秦始皇多少岁去世了	秦始皇
什么国家是电影的发源地	电影
cortana的模型是谁	cortana
哪年有了第一台计算机	计算机
羊肉的味道你晓得不	羊肉
做出熊猫烧香的人叫啥	熊猫烧香
裴秀智经常用哪种运动锻炼身体	裴秀智
四分位数的示例	四分位数
内科的治疗手段	内科
麻生希享受做什么	麻生希
微微一笑很倾城花的是哪个公司的钱	微微一笑很倾城
张国荣跨越97演唱会的唱片发行商是哪家公司	张国荣跨越97演唱会
唐舞麟的妈妈叫什么	唐舞
伊丽莎白·巴托里喜欢什么	伊丽莎白·巴托里
悦的字音怎么写	悦
电脑配置的含义	电脑配置
琅琊榜首播时间	琅琊榜
琅琊榜的首播日期	琅琊榜
霍建华到哪	霍建华
太阳表面温度是多少	太阳
霍普谁当家	霍普
范冰冰是哪种血的人	范冰冰
追无耻之徒需要追几季	无耻之徒
绘画的主要组成	绘画
崔健的厂牌	崔健
不锈钢的成分是啥	不锈钢
是什么发展成了c语言的	c
简单解释下什么是fscanf	简单
罗永浩的生日	罗永浩
百度百科是哪个公司的	百度百科
奇门遁甲又号称为什么	奇门遁甲
新金瓶梅被算作是哪个级别	新金瓶梅
重庆的所在区域	重庆
腰椎间盘突出症一般哪里先发病	腰椎间盘突出症
名侦探柯南：纯黑的恶梦的首映日期	名侦探柯南
冰与火之歌译者是谁	冰与火
哪个民族是中国人口的主要民族	人口
拉斯维加斯是啥时候出现的	拉斯维加斯
富士康的老板是谁	富士康
神司马懿的技能	神司马懿
是从什么时间开始造的天安门	天安门
白鹿原首次出版是哪年	白鹿原
多少是金毛寻回犬的标准高度	寻回犬
咖喱是什么味道的	咖喱
董力属于哪个运动队的	董力
des的体系	des
洛天依的角色配音是谁	洛天依
陈绮贞是哪种类型的音乐人	陈绮贞
辛普森杀妻案里面有谁	辛普森杀妻案
神奇动物在哪里的编剧是哪位	神奇动物
唐纳德·特朗普的信仰是什么	唐纳德·特朗普
星座来源于哪	星座
寒战2拍摄时间	寒战2
斗罗大陆是什么时候开始面向大众的	斗罗大陆
神印王座的画者	神印王座
蓝牙指什么	蓝牙
幻灯片还意味着什么	幻灯片
用英语说演员	英语说
原纱央莉叫什么	原纱央莉
bangbangbang是哪国语言	bangbang
刘慈欣职务	刘慈欣
皇后大道东专辑中有多少首歌	皇后大道
kenarai早期作品是哪首	kenarai
ac米兰足球俱乐部的队歌是什么	ac米兰足球俱乐部
中国国家女子排球队的英文名字	中国国家女子排球队
燕麦的毒性有哪些	燕麦
文艺复兴作为一场思想文化运动它的核心是什么	思想文化
谁发明的3d打印	3d
铁凝的姓氏能告诉我	铁凝
秦岭都做过哪些活动	秦岭
石进生活在哪个城市	石进
许巍平时都喜欢做什么	许巍
穿运动鞋的感受	运动鞋
神奇动物在哪里的作者么	神奇动物
谁做出的seeyouagain	seeyou
猫在动物界中是什么科纲的	猫
清明上河图是哪个时期的	清明上河图
最先使用wechat的是哪国	wechat
塞卡病毒是什么	病毒
vhd属于哪儿	vhd
lorde唱歌的风格	lorde
亚洲足球锦标赛的举办地点	亚洲足球
供应链的思想源于什么	供应链
长沙的高校	长沙
网易公司的股票上市号码	网易公司
在什么领域上主要用到ssid	ssid
哪个系统有自动关机命令	自动关机命令
抑郁症常出现的症状	抑郁症
新干线理论基础是什么	新干线
饕餮的原意	饕餮
拉布拉多猎犬都分布在哪里	拉布拉多猎犬
原来你还在这里的台词语种	原来你
冰菓的制作经理	冰菓
乳腺结节如何治疗	乳腺结节
金茂大厦的高度	金茂大厦
哪些人是关之琳的好友	关之琳
赵一荻的夫君	赵一荻
张若昀歌曲作品有哪首歌	张若昀
谁是王健林的妈妈	王健林
上海迪士尼乐园是什么气候	上海迪士尼乐园
花了多长时间才把巴黎圣母院建成的	巴黎圣母院
呼斯楞的唱歌风格	呼斯楞
新干线的正确阐述是什么	新干线
大数据是谁提出的	大数据
阿特拉斯的一些故事	阿特拉斯
长白山脉的主峰	长白山脉
什么季节有冬至	冬至
斯卡哈的学生	斯卡哈
ip地址的分类	ip地址
海词有几种作用	海词
解释下hash	hash
清明上河图的背景朝代是	清明上河图
海南的高校都有哪些	海南
识汝不识丁的特色	识汝不识丁
白鹿原第一次出版是什么时候	白鹿原
相对原子质量表中56号ba元素对应的数值是多少	相对原子质量表
幻灯片还能是什么	幻灯片
老炮儿卖门票带来多大的流水	老炮儿
刘亦菲有没有别的名字	刘亦菲
管理学有哪些代表人物	管理学
梅兰芳是什么民族族群的	梅兰芳
社会保险因什么目标而生	社会保险
李飞飞的任职	李飞
迪拜的面积有多少	迪拜
灵魂摆渡3通过什么平台播放	灵魂摆渡
哪个公司是林允所在的公司	林允
voc对人有什么不好	voc
比亚迪股份有限公司面积的总和是多少	比亚迪股份有限公司
sat的别称是什么	sat
同位语从句用法	同位语从句
lemontree演唱者	lemontree
把滕王阁序划分在哪类的文学作品里了	滕王阁序
哪个词是抖s的对义词	抖s
瑜伽节的具体日期是多会儿	瑜伽
你认识xamarin	xamarin
长城在哪儿	长城
php是谁设计的	php
大肠杆菌的生物种类划分	大肠杆菌
老舍的别名是	老舍
大熊猫的生物门类	大熊猫
济南的特产	济南
皇家马德里足球俱乐部的队长	皇家马德里足球俱乐部
树莓派的简写	树莓派
京韵大鼓的流行地区在哪里	京韵大鼓
高桥李依出道时间	李依
麻雀的生物分类	麻雀
权力的游戏的出资公司	权力的游戏
蜂蜜的主要原料是什么	蜂蜜
文明5对战平台	文明5
魔兽拍摄日期是哪天	魔兽
闪电侠的能力有哪几种	闪电侠
广州的邮政区码	广州
爱新觉罗·玄烨的尊称是什么	爱新觉罗·玄烨
研究员主要负责什么	研究员
华山的距离是多少	华山
山东火车站分别在哪	车站
去张家界哪个机场方便	张家界
cp的来源是什么	cp
人们眼中的木村拓哉是怎样的	人们
日本的首都是哪座城市	日本
1的汉语拼音	1
尿毒症有什么症状	尿毒症
淘宝网成立在哪天	淘宝网
乳腺结节怎么治	乳腺结节
重庆在哪一块儿	重庆
动画片名侦探柯南剧场版谁写的原著	名侦探柯南剧场版
简单爱的合声编曲是谁	简单爱
陈氏太极拳流传国家在哪里	陈氏太极拳
梅兰芳的民族族群是什么	梅兰芳
南北朝首都有哪些城市	南北朝
丢番图在哪年长眠于世的	丢番图
山东火车站站点是	车站
哪些部件是固态硬盘关键的组成部分	固态硬盘
三毛嫁给谁了	三毛
为什么会有云盘	云盘
美丽的春天的演唱者是谁	美丽的春天
丑八怪在哪个专辑里被推出的	丑八怪
痰是由什么产生的	痰
苏小妹的爸爸	苏小妹
杜鹃擅长做什么	杜鹃
ipv6具体叫什么	ipv6
神奇女侠的爸爸	神奇女侠
超少年密码的播放状况	少年
海绵宝宝的其他译名	海绵宝宝
生死狙击玩家可以有多少	生死狙击
麻生希乐意做什么	麻生希
angelababy属什么的	angelababy
甘雅丹是什么唱法	甘雅丹
126的简介是什么	126
哪年开始有的docker	docker
萨尔养的坐骑是什么	萨尔
切·格瓦拉的配偶	切·格瓦拉
年轮说专辑数量简介	年轮
项羽是什么族群的	项羽
第二次世界大战经过了哪些地方	第二次世界大战
啥时候出现的詹天佑	詹天佑
周二珂在哪里工作	工
什么专业是王鸥学的	王鸥
白茶产地主要有哪些	白茶
如何进行职称评审	职称
乔任梁是哪个星座	乔任梁
谁是神印王座的漫画作者	神印王座
关于郑州的记忆里谁会打鼓	关于郑州的记忆
酉阳杂俎是什么时候的	酉阳杂俎
顺丰速运在哪里成立	顺丰速运
web有什么特别的意思	web
钟丽缇会几国话	钟丽缇
泰勒·斯威夫特亮相于何时	泰勒·斯威夫特
贝拉克·奥巴马爱人资料	贝拉克·奥巴马
伏地魔是哪年生的	伏地魔
kenarai经典老歌	kenarai
盗墓笔记的总监制	盗墓笔记
中南海的地点在哪	中南海
唾液是什么东西	唾液
东南亚国家联盟一共多少平方	东南亚国家联盟
可见光的速度是多少	可见光
ig老板名字叫	ig
常用的在线翻译的工具都有哪些	在线翻译
社会保险的目标	社会保险
抑郁症会导致哪些常见现象	抑郁症
不锈钢有几种主要材质	不锈钢
秋葵是哪种物种里的	秋葵
后来的我们的mv导演	后来的我们
能不能说下精灵梦叶罗丽第四季有多少集	精灵梦叶罗丽
美国具体在地球的哪个大洲上	美国
曼莎珠华代表着什么	莎
faded的原唱是谁	fad
这样爱了的版权归属是哪家唱片公司	这样爱了
伊利诺伊大学厄巴纳-香槟分校是一所什么性质的大学	伊利诺伊大学厄巴纳-香槟分校
王俊凯的本事	王俊凯
讲讲长城地处位置	长城
北京故宫的大小	北京故宫
蜂蜜的材料有哪些	蜂蜜
盗墓笔记总监制是哪位	盗墓笔记
天宫一号有多长	天宫一号
包装杨幂唱片的是哪家公司	杨幂
哪年创办的台湾电影金马奖	台湾电影金马奖
王家卫的亲人有谁	王家卫
腾讯总裁	总裁
阿尔伯特·爱因斯坦最出名的论据	阿尔伯特·爱因斯坦
哪张专辑中有三味线	三味线
表情符号有哪些含义	表情符号
黑洞的直径你晓得么	黑洞
生物学怎么给猫分的类	生物学
到什么季会有冬至	冬至
加拿大的国庆在哪一天	加拿大
什么时候创建的草榴社区	草榴社区
关之琳的好友是谁	关之琳
供应链的概念源于什么	供应链
黄致列的歌	歌
你告诉我爱奇艺外文名	爱奇艺
追梦赤子心都获得了什么奖	追梦赤子心
慈溪的陵园	慈溪
唱t的人	t
matlab的全称	matlab
行尸走肉的作者到底是谁	行尸走肉
拉面一般怎么做	拉面
谁导的欢喜密探	欢喜
丁墨的具体位置是哪	丁墨
哪些方式能融资	融资
刘邦什么时候死的时候是什么年	刘邦
cortana取材于哪里	cortana
改革开放所起的作用	改革开放
用来听完一人我饮酒醉的时间有多长	饮酒
迪士尼的总部在哪里	迪士尼
哪个地方有虎牙	虎牙
中国好声音第五季属于什么类型的节目	中国好声音第五季
陈奕迅现在是谁管理的	陈奕迅
黄山是几a级旅游景区	黄山
姚明的闺女是谁	姚明
163邮箱的作用	163邮箱
饕餮的本义么	饕餮
美人鱼学名	美人鱼
自然常数是怎么算的	自然常数
是谁翻译的冰与火之歌	冰与火之歌
cp是通过什么演变过来的	cp
二八定律的其他说法	二八定律
苹果的首席执行官	苹果
皇家马德里足球俱乐部的领队是哪位	皇家马德里足球俱乐部
熊猫tv还能怎么说	熊猫
瓜德尔港在哪个城市能看到	瓜德尔
想看拉布拉多猎犬需要到哪里	拉布拉多猎犬
bangbangbang语言是什么	bangbang
尤克里里什么材质的好	克里
高铁时速是多少	少
nba创立时间	nba
欢乐颂的谱曲	欢乐颂
松花江的流域面积有多大	松花江
痰的组成	痰
南京地铁3号线什么时候开始运行的	南京地铁3号线
惠普的董事长是谁	惠普
谁收了梁经伦做学生	收
虎牙是什么地方的	虎牙
绘画的重要组成部分	绘画
美丽的春天这首歌谁唱的	美丽的春天
灵蝶有什么身份	灵蝶
加拿大的国庆在每年的几月几号	加拿大
青岛市工商行政管理局的具体位置是什么	青岛市工商行政管理局
多少钱被老炮儿赚走了	老炮儿
操作系统的成分	操作系统
秦时明月之君临天下的别称叫啥	秦时明月之君临天下
朱子的离世日期	朱子
是谁给黎明生机做的混音	黎明生机
osi参考模型是哪年设立的	osi参考模型
谁是漩涡慕留人的妹妹	漩涡慕留人
书信的对义词	书信
个人简历里面需要添加哪些东西	个人简历
博柏利是什么牌子	博柏利
蜂蜜是什么成分组成的	蜂蜜
滕王阁序的文学体裁	滕王阁序
哪里是迪士尼的总部	迪士尼
加利福尼亚州有意思的地方	加利福尼亚州
文明5的游戏平台	文明5
谁曾诠释过赵敏	赵敏
潘金莲的朝代	潘金莲
于谦师父	于谦
托福种类	托福
谁创建了windows操作系统	windows操作系统
曹操的称号叫什么	曹操
adobeillustrator初次发布是在哪年	adobeillustrator
上瘾是谁的歌	上瘾
哪些地方是南北朝首都	南北朝
霍建华长多高	霍建华
为了把维生素c化掉需要让温度到达多少	维生素c
龚琳娜的伴侣	龚琳娜
欢喜密探谁导的	欢喜
007有哪些喜好	007
能说几个英文名	能
arduino奠基人的名字	arduino
sktelecomt1的英文名称是	elecom
埃博拉病毒的危害	埃博拉病毒
人字的四角号码	码
巴厘岛的交流语言	巴厘岛
g20峰会第一届在哪年召开的	g20峰会
西游记属于什么类别的书	西游记
厦门方言叫什么	厦门
原纱央莉叫什么不	原纱央莉
搜索引擎有多少种分类	搜索引擎
疯狂动物城的imdb编码是	动物城
volte的意思	volte
珠穆朗玛峰多少钱一张票	珠穆朗玛峰
什么活动选在盂兰盆节做	盂兰盆节
mindgeek是由哪个团队研发的	geek
扭矩的数值	扭矩
陪唐僧取经的有哪些	些
小别离制片人	小别离
你听过火影忍者：漩涡博人传的主题曲	火影忍者
国有企业改革是怎么产生的	国有企业改革
徐志摩前妻	徐志摩
胡歌的祖籍	胡歌
汽车还可以怎么说	汽车
苏秦拜谁当老师	苏秦
cfr应用在哪个领域里	cfr
张艺兴是哪个组合的	张艺兴
bmi指数还有什么其他说法	bmi指数
济州岛管事的是哪	济州岛
牙套好用的原因	牙套
美丽的春天是谁演唱的	美丽的春天
世界博览会有几种票	世界博览会
市净率的算法有哪些	市净率
搜狗母公司是什么	搜狗
克里斯汀·斯图尔特的血统主要是什么	克里斯汀·斯图尔特
詹天佑是啥时期的人	詹天佑
自考专升本算什么学历	自考专升本
辞职信的主要结构	辞职信
潘金莲是什么时期的人	潘金莲
迪拜占地面积是多少	迪拜
谁是伊万卡·特朗普的老公	伊万卡·特朗普
秦时明月之君临天下还有其他的叫法	秦时明月之君临天下
鸡蛋果是哪个属的么	鸡蛋果
维生素c达到几度的时候会化	维生素c
瓜德尔港所属城市	瓜德尔
长白山脉最高的峰是哪个	长白山脉
哪些是章鱼哥的小伙伴	章鱼哥
哪些人管玄奘叫老师	玄奘
李未央有哪个妹妹	李未央
杨绛的女儿是谁	杨绛
大学问出自哪个作曲人	大学问
猪八戒的扮演者	猪八戒
五四运动改变了什么	五四运动
acl的固定准则	acl
该怎么找windows.old	windows.old
七鳃鳗食性	七鳃鳗
自然常数公式有哪些	自然常数
梦想的声音一般每周几开播	梦想
ptc含有哪些成分	ptc
一共有多少人在youtube工作	工作
奇门遁甲还有什么名头	奇门遁甲
三七粉的作用	三七粉
引号表示什么么	引号
极乐净土日语发音	极乐净土
在哪能找到rename	rename
无锡的火车站站点都有	无锡
中山最有名的花你知道是什么花	中山
直男癌的由来	直男癌
核工业404的位置在哪	核工业
哈利·波特的作品名称	哈利·波特
能说出几种济南特产	几种
绿罗裙谁是原唱	绿罗裙
文艺复兴运动时期的主要主张是什么	文艺复兴
rs485长度	rs485
甄嬛有哪个恋人	甄嬛
尹恩惠的最高学历是什么	尹恩惠
你认识京东总部	京东
上海虹桥国际机场的占地是多少	上海虹桥国际机场
nba诞生于	nba
年轮说专辑的歌曲总数	年轮
谁给画江湖之不良人作的曲	画江湖之不良人
192.168.1.1的分类	192.168.1.1
武汉的地理坐标	武汉
s.t.的汉语是什么	s.t.
刘承羽的谁的学生	刘承
沙溢的老婆是谁	沙溢
光波炉以什么而号称	光波炉
什么叫hadoop	hadoop
那个晋祠圣母殿侍女像从上到下一共有多少米	晋祠圣母殿侍女像
127.0.0.1是干嘛用的	127.0.0.1
你懂site什么意思不	ite
内战的预兆的创作时间是	内战的预兆
庐山面积大小	庐山
这样爱了版权	这样爱
cvt的工作原理是什么	cvt
用什么才能制作出陶瓷	陶瓷
四大会计师事务所的组成机构	四大会计师事务所
摩尔斯电码是谁发明的	摩尔斯电码
人民日报什么时候出现的	人民日报
皇后大道东的专辑曲目	皇后大道东
闪电侠的能力是什么	闪电侠
计算市净率的方法有什么	市净率
原始的通勤是个什么	原始
匈牙利的核心银行	匈牙利
章泽天和谁处对象	章泽天
简单的陈述一下fscanf	fscanf
中国国家女子排球队英文怎么表达	中国国家女子排球队
姜思达在哪个学校求过学	姜思
新金瓶梅具体是什么程度的	新金瓶梅
雪儿的曲风是什么	雪儿
吴亦凡多沉	吴亦凡
3d肉蒲团之极乐宝鉴的制片人是谁	3d肉蒲团之极乐宝鉴
苹果的首席执行官么	苹果
高铁的快慢是多少	慢
黄致列的歌推荐几首	黄致列的歌
纸牌屋的imdb编号	纸牌屋
王莽有哪些年号	王莽
中东信奉什么宗教的	中东
马思纯是哪个民族的	马思纯
php是谁设计出来的	php
1024程序员节有什么风俗习惯	1024程序员节
王俊凯有哪些特长	王俊凯
联想集团的国家	联想集团
李相赫的别名还叫什么	李相
贝拉克·奥巴马的爱人	贝拉克·奥巴马
幻灯片版式这个词是从哪里出来的	幻灯片
劳尔·卡斯特罗的哥哥	劳尔·卡斯特罗
巴黎圣母院是从什么时候开始建造到什么时候结束的	巴黎圣母院
海绵宝宝的其他叫法	海绵宝宝
原来你还在这里的台词是什么语种	原来你
谁给小别离投资的	小
什么状况是runtimeerror会存在的	runtimeerror
神印王座的创作者是谁	神印王座
给我说下饕餮原本的意思	饕餮
iphone7中用的系统叫什么	iphone7
太岁里面都有什么	太岁
一提起什么名字大家就知道是田馥甄的粉丝了	田馥甄
4399小游戏的总部地址	4399小游戏
什么时候有的拉斯维加斯	拉斯维加斯
聚氯乙烯是什么颜色的	聚氯乙烯
内科有什么可靠的医疗方法	内科
什么叫唾液么	唾液
哪些作品代表王维的个人成就	王维
能不能说出地址在洛阳的高等院校名字/	不能说
非洲的原本含义	非洲
唱游击队歌的那个人叫什么	游击队歌
可行性研究报告的要求	可行性研究报告
天安门始建于什么时候	天安门
无锡火车站具体有哪几个	车站
解释一下动漫的定义	动漫
幽门螺杆菌的类别	幽门螺杆菌
奇迹暖暖联机平台	奇迹暖暖
扭矩的数值是什么	扭矩
冬至可以代表什么季节	冬至
伊利诺伊大学厄巴纳-香槟分校是什么性质的大学	伊利诺伊大学厄巴纳-香槟分校
透明质酸的化学式写法	透明质酸
比亚迪唐的首发日期是哪年	比亚迪唐
什么操作系统应用在iphone7上	iphone7
胰岛素有哪些分子式	胰岛素
千图网好用的点在哪	千图网
虎妈猫爸的播出方式	虎妈猫爸
借记卡使用方法	借记卡
上海虹桥国际机场建筑面积的数值是多少	上海虹桥国际机场
李易峰粉丝称号	李易峰
人字的四角号码	码
mybatis本名	mybatis
树莓派的其他说法	树莓派
冬至是什么季节里独有的	冬至
你告诉我加拿大人的语言是什么语	加拿大人
什么时候有的第一台电脑	第一台电脑
中山的市花是什么	中山
王嘉尔和谁在一起生活	王嘉尔
四个全面的提出人	四个全面
四个全面被谁提出的	四个全面
转义字符的另一个说法	转义字符
陈赫口头禅	陈赫
拉面的制作方法	拉面
洋葱怎么做好吃	洋葱
白素贞妹妹叫什么	白素贞
什么地方曾经发射了神舟十一号飞船	神舟十一号飞船
谁拍的天龙八部	天龙八部
pthread_cond_wait怎么搭配好	pthread_cond_wait
天宫一号的总长	天宫一号
表情符号阐述了什么	表情符号
bootstrap属于什么	bootstrap
史蒂夫·乔布斯的妈妈是哪位	史蒂夫·乔布斯
梦想的声音多会儿开播	多会
安庆都有哪些大学	安庆
伪装者原来叫什么	伪装者
拳皇13是怎样的电影	拳皇13
詹天佑生活在哪个朝代	詹天佑
操作系统都代表了什么	操作系统
来自青岛的车牌上都写着什么代码	青岛
原来你还在这里的台词信息	原来
开发了unity3d的公司名字	unity3d
什么花是中山的市花	中山
想要职称评审需要用哪些办法	职称评审
塞卡病毒是由什么病毒引发的	病毒
谁跟关之琳关系很好	关之琳
cortana的原型	cortana
都哪些风格里有公主头	公主头
悦的字音	悦
固态硬盘具体是由什么组成的	固态硬盘
visa其他译名叫什么	visa
农业电子商务目前的情况	电子商务
哪年开始有台湾电影金马奖的	台湾电影金马奖
崔健的音乐厂牌	崔健
后来的我们的mv导演叫什么	后来的我们
timbaland的唱片公司是什么	timbaland
web的意义	web
莫文蔚的偶像是谁	莫文蔚
雅思英文名可以缩成什么	雅思
火影忍者：漩涡博人传的主题曲	火影忍者
择天记在哪个网站首发的	择天记
哈利·波特有哪些名字	哈利·波特
在哪里看中国式关系	中国式关系
快告诉风信子的花语吧	风信子
联想集团是哪个国家的	联想集团
柏拉图有个怎样的老师	柏拉图
bigbang是什么人	bigbang
李世民的庙号是	李世民
资本一词如何解释	资本
纸牌屋的imdb编号是	纸牌屋
加利福尼亚州都有哪些著名景点	加利福尼亚州
知网性质是什么	知网
通勤的前身	通勤
酷儿体重身高	酷儿
克里斯汀·斯图尔特的血统是什么	克里斯汀·斯图尔特
美元指数是从哪里来的	美元指数
诸葛亮长眠于哪天	诸葛亮
des的体系有什么	des
威尼斯有什么好的特产	威尼斯
陆雪琪的爱人	陆雪琪
lachata专辑歌曲列表	lachata
太阳表面的温度	太阳
rename在计算机里面哪个地方	rename
深圳地铁11号线什么时候开通	深圳地铁11号线
华山直径距离是	华山
美丽新世界归什么所有	美丽新世界
景甜的毕业院校是什么	景甜
给lovelive!砸钱的公司叫什么	lovelive!
玉米这首歌到底是谁唱的	玉米
绝世唐门的作品标签	绝世唐门
拍摄投名状花了多少钱	拍摄
泰勒·斯威夫特踏足娱乐圈的时间	泰勒·斯威夫特
锦绣未央值多少	锦绣未央
什么途径可以传染上梅毒	梅毒
matlab是什么的简易写法	matlab
scratch是什么	scratch
鹿晗哪国人你知道不	鹿晗
简单爱的合声是谁编写的	简单爱
1号店这家公司用的什么口号	1号店
草榴社区创建于	草榴社区
长沙有哪些高等学府	长沙
龙眼的生物目属	龙眼
拉斯维加斯是什么时候建立的	拉斯维加斯
伊万卡·特朗普的老公是谁	伊万卡·特朗普
澳大利亚主要人口在哪几个城市	澳大利亚
windows.old跟哪儿么	windows.old
ebsco位于	ebsco
列举几个四分位数的示例	四分位数
当维生素c开始化掉的时候温度一定是在多少度	维生素c
淘宝网的什么时候成立的	淘宝网
深圳地铁11号线的通车日期是多会儿	深圳地铁11号线
奇妙能力歌的词是谁写的	奇妙能力歌
尿毒症是什么引起的	尿毒症
三味线的专辑名是什么	三味线
哪年发布的adobeillustrator	adobeillustrator
可行性研究报告的原则	可行性研究报告
ac米兰足球俱乐部的主打歌是什么	ac米兰足球俱乐部
印度的人口数量	印度
碳酸氢钠密度大小是多少	碳酸氢钠
youtube有多少雇员	youtube
什么性别特点是有阴茎	阴茎
广州的邮编	广州
上升星座会影响什么	上升星座
向日葵的特色	向日葵
绝世唐门的类别	绝世唐门
bmi指数的简称	bmi指数
齐鲁制药有限公司占地有多大	齐鲁制药有限公司
游戏人生打造出了一种什么样的画面	游戏人生
新加坡英文名称	新加坡
孤独怎么英译	孤独
丁墨的具体位置	丁墨
核工业404的地理位置在哪	核工业
创造了熊猫烧香的是哪个人	熊猫烧香
陶瓷由什么制作而成的	陶瓷
关之琳跟谁关系最好	关之琳
荷塘月色的创作时间	荷塘月色
滨崎里绪是哪年出道的	滨崎里绪
苏州总体有多少人	苏州
绝世唐门的重要标签是什么	绝世唐门
滕王阁序这样的文学作品都叫做什么	滕王阁序
尹恩惠的学历是什么	尹恩惠
德国国歌是哪首	德国国歌
谁是中国新歌声的主持人	新歌
创作出铳皇无尽的法夫纳的人叫什么	铳皇无尽的法夫纳
胡歌的祖籍在哪儿么	胡歌
供应链的根源	供应链
杨绛的闺女叫什么	杨绛
刘娜萍的音乐作品	刘娜萍
济州岛的核心是哪	济州岛
司马懿去世时间	司马懿
sktelecomt1的英文名字是	elecom
现代简约风格源自	现代简约风格
陈寅格是什么时期的人	陈寅
这个php是谁研究设计出来的	php
东南亚国家联盟一共的面积	东南亚国家联盟
机械键盘的优点有哪些	机械键盘
在多少温度下维生素c会熔化	维生素c
bose公司设在哪个地方	bose
机器学习涉及哪些学科	机器学习
什么叫volte	volte
正态分布被哪个人发现的	正态分布
蜂蜜里都含有什么营养	蜂蜜
尊重咋解释	咋
一般端午节都会吃什么	端午节
和五证合一相近的词语有哪些	合一
pthread_cond_wait配合什么最好	pthread_cond_wait
开发unity3d的是哪个公司	unity3d
河北华夏幸福足球俱乐部是什么角逐赛	河北华夏幸福足球俱乐部
极限挑战的播出状态知道不	极限挑战
写色情小说的要求	色情小说
新三板开始时间	新三板
切·格瓦拉的另一半是谁	切·格瓦拉
立体电影又叫什么	立体电影
瑜伽这个节日是什么时间	瑜伽
哪个是疯狂动物城的imdb编码	动物城
nakedgirls如何被称呼的	nakedgirls
海绵宝宝的其他叫法	海绵宝宝
讲讲四项法则吧	法则
里番什么意思	里番
亮剑什么颜色	亮剑
梦田的合声是谁	梦田
蓝色大海的传说中文名	大海的传说
sumif函数的表达式	sumif函数
蓝光的所属领域有哪些	蓝光
美国大选在什么地区举行	美国
四大会计师事务所的组成部分	四大会计师事务所
5·12汶川地震的名称	5·12汶川地震
郑州都有哪些辉煌的人物	郑州
长城在哪儿	长城
什么话是陈赫的口头禅	陈赫
万圣节用英语怎么说	万圣节
创作出威风堂堂曲子的人	威风堂堂
胰岛素分子式	胰岛素
老炮儿的票房成绩	老炮儿
毛泽东与世长辞的具体日期	与世长辞
身体乳的作用是什么	身体乳
大熊猫是什么类别的	大熊猫
kvm有什么样的优点	kvm
富士康创立者名字是	富士康
张宇有着怎样的恩师	张宇
黑五	五
歌诗达邮轮展现出什么特点	歌诗达邮轮
岳云鹏的固定搭档是谁	岳云鹏
朋克起源时期是什么时候	朋克
石进现在住什么地方	石进
谁是李小龙的子女	李小龙
rsa算法是谁提的	rsa算法
什么机场坐落于张家界	张家界
des的类型有哪些	des
nakedgirls被宣称是什么	nakedgirls
kenarai音乐作品资料	kenarai
伪装者改编于什么	伪装者
朴槿惠的婚姻状况是怎样的	朴槿惠
那些人是唐僧的徒弟	唐僧
饕餮最初指什么	饕餮
诛仙青云志原来是什么	青云志
墨西哥多少平方公里	墨西哥
什么算法是双曲线离心率的	双曲线
鲁路修·兰佩路基身份是怎样的	鲁路修·兰佩路基
岳云鹏的搭档有谁	岳云鹏
从你的全世界路过能看多久	从你的全世界路过
tfboys的出生地是哪儿	tfboys
在哪有幻灯片版式这个词的	幻灯片
诗经又名	诗经
录制蒙面唱将猜猜猜是在哪个国家	猜猜猜
flytothesky唱歌什么风格	flytothesky
甘雅丹的演唱风格是什么	甘雅丹
丁墨在什么地方	丁墨
风信子的花语有哪些	风信子
node.js发布的时间是多会儿	node.js
讲讲hash的意思	hash
晓得纽约邮政区码不	纽约
谁收游坦之当学生了	游坦之
甘雅丹的歌曲风格是什么	甘雅丹
投名状有着怎样的制作成本	投名状
洋葱的怎么吃	洋葱
啥时候更新梦想的声音	新梦想
日本有首都	日本
马思纯不是回族人吧	马思纯
张继科拿走的那个奖叫什么	张继科
鲁路修·兰佩路基有着什么样的头衔	鲁路修·兰佩路基
你曾是少年专辑的类别	你
seo的诞生日期具体在多会儿	seo
国际歌有哪些特征	国际歌
surfacepro4啥系统	surfacepro
1在中国怎么读	1
谍影重重的分级	谍影重重
木村拓哉的个人魅力有哪些	木村拓哉
纪昀活到多大	纪昀
苹果的ceo	苹果
从什么演变成cortana的	cortana
领导苏联的是谁	苏联
相爱穿梭千年通过何种方式播出	相爱穿梭千年
rs485多长	rs485
莫度男爵的师傅叫什么	男爵
cortana源于什么	cortana
东南亚国家联盟面积有多大	东南亚国家联盟
东南亚国家联盟占了多少面积	东南亚国家联盟
喝可乐有什么坏处	可乐
清明上河图是哪朝的	清明上河图
章鱼哥的朋友	章鱼哥
在巴厘岛都说什么语	巴厘岛
英文名的举例有哪些	英文名
ssid有什么用武之地	ssid
机器学习的应用范畴	机器学习
ig掌门人是哪位	ig
徐志摩第一任妻子	徐志摩
裴秀智的哪些运动最受欢迎	裴秀智
黎明生机的混音是谁	黎明生机
余罪一集大概多少分钟	余罪
hadoop是什么东西	hadoop
代表双子座的是什么	双子座
吴亦凡的体重是多少	吴亦凡
十八大报告里面是不是有关于五位一体的说法	八大报告
如果蜗牛有爱情的isbn	如果蜗牛有爱情
哪些人主演的九州·天空城	天空城
sleep函数怎么用	sleep函数
大麦茶的益处都有什么	大麦茶
惠普的董事长呗	惠普
阿里巴巴集团的地址能告诉我	阿里巴巴集团
宋仲基的粉丝如何称呼	宋仲基
中山的市花是什么花	中山
广州国际灯光节的门票情况	广州国际灯光节
九州·天空城有哪些主演	天空城
吴亦凡的重量	吴亦凡
多少钱可以买到锦绣未央	锦绣未央
细胞粒物的计算量是多少	细胞
写色情小说有要求	色情小说
社会保险主要是为了什么	社会保险
windowspowershell是在什么平台上运行操作的	windowspowershell
vhd归属于哪里	vhd
阿特拉斯的故事是什么	阿特拉斯
什么杂志接受了对哆啦a梦的连载	哆啦a梦
王牌逗王牌的对白种类是什么	王牌
foxmail的名字	foxmail
孙悟空的来历	孙悟空
罗马数字怎么发音	罗马数字
如何融资	融资
半月板主要都会由于什么而生病	半月板
匆匆的首版日期	匆匆
jira出品自	jira
诗经又叫什么	诗经
啥能播放流媒体	流媒体
北京四环路的坐标在哪儿	北京四环路
那个土星5号运载火箭多少米	土星5号运载火箭
社会保险的用处	社会保险
rename具体位置是哪	rename
加利福尼亚大学伯克利分校唱的这首校歌	加利福尼亚大学伯克利分校
t-ara什么时候出道的	t-ara
广州国际灯光节要门票	广州国际灯光节
centos如何收费	centos
追梦赤子心的获得奖项	追梦赤子心
唐家三少长的怎么样	唐家三少
梅兰芳是什么民族族群的	梅兰芳
是哪个歌手唱的玉米这首歌	玉米
什么叫pdca循环	pdca循环
清明上河图的绘制时间是	清明上河图
海洋的体积到底有多大	海洋
唐纳德·特朗普的宗教信仰是什么	唐纳德·特朗普
圣诞节	圣诞节
cp这种说法是通过什么流传到现在的	cp
谁主演的西部世界不	西部世界
中国什么好玩儿的地方	中国
什么地方可以用到中央电视台	中央电视台
怎么写塞浦路斯的英文	塞浦路斯
核心期刊的理论	核心期刊
哪安放着慈禧的坟墓	慈禧
sleep函数的用法是什么	sleep函数
富士康属于谁的企业	富士康
土星5号运载火箭有多高	土星5号运载火箭
太阳能热水器运用了什么原理	太阳能热水器
hao123的所属公司是哪家	hao123
流媒体通常播放于	流媒体
哪些地方曾经被第二次世界大战牵连	第二次世界大战
灵能百分百授权给哪家网站进行的连载	灵能百分百
华为音乐音乐版权属于哪家公司	华为音乐
帝霸小说现在什么进度	帝霸
lisp的起源	lisp
巴黎人主要信什么教	巴黎人
导致半月板生病的主要原因	半月板
最后的问候的词曲是谁	最后的问候
绘画的主要构成	绘画
拾穗者活到了什么时候	拾穗者
做蒲笋都需要什么	蒲笋
新三板起源	新三板
改革开放意义为何	改革开放
滕王阁序是什么类型的文学作品	滕王阁序
都哪天被设定成鬼节了	鬼节
在什么时候高桥李依出道的	李依
李易峰粉丝名	李易峰
北魏总人数	北魏
社会保险是以什么为目标的	社会保险
苏联最高领导人叫什么名字	苏联
魔幻车神的发行商是谁	车神
valve的员工数量	valve
crispr/cas9是什么东西	isp
呼斯楞的音乐风格	呼斯楞
木心教过谁	木心
萌萌哒天团创办地点	萌萌哒天团
不锈钢由什么制成	不锈钢
风信子的花语	风信子
奚梦瑶爱好是什么	奚梦瑶
伊利诺伊大学厄巴纳-香槟分校的类型	伊利诺伊大学厄巴纳-香槟分校
给我介绍几个常用的在线翻译工具呗	常用
陈奕迅经纪人名字是	陈奕迅
游戏人生在画质方面有什么出彩的地方么	游戏人生
谁是腾讯老板么	腾讯
詹天佑什么时候生出来的	詹天佑
跟章鱼哥一起玩的有哪些	章鱼哥
地球多沉	球多
走向共和都可以在哪些地方可以看到	走向共和
木村拓哉有什么个人魅力	木村拓哉
自然常数公式	自然常数
小米手机5用什么操作的	小米手机5
甘肃	甘肃
唐纳德·特朗普的宗教信仰	唐纳德·特朗普
火影忍者剧场版作者名字吧	火影忍者剧场版
美元发行于	美元
身体乳干嘛用的	身体乳
pmo的作用是	pmo
神司马懿有什么用	神司马懿
红茶属于哪个目里么	红茶
s的相对原子质量	s
追梦赤子心被列入什么奖项中了	追梦赤子心
葛雷·奥特曼谁唱的	葛雷·奥特曼
珠穆朗玛峰的票价是多少	珠穆朗玛峰
云盘原理	云盘
张艺兴的组合叫什么	张艺兴
哪家公司旗下有百度百科	百度百科
东京的人口	东京
甘雅丹的音乐曲风是啥	甘雅丹
怎么去拼1	拼
火影忍者剧场版的原作者是谁	火影忍者剧场版
举重妖精金福珠的首播时间么	妖精
空气质量指数的级别是多少	空气质量指数
runtimeerror通常会发生什么	runtimeerror
1989这部专辑的总时长是多少	1989
无锡有几个火车站	无锡
唐家三少长什么样	唐家三少
关于sktelecomt1的英文名称	elecom
周星驰原籍是哪儿的	周星驰
上海迪士尼乐园的气候类型	上海迪士尼乐园
诛仙的主要角色	诛仙
菲德尔·卡斯特罗的出生日期	菲德尔·卡斯特罗
陈奕迅经纪人	陈奕迅
切·格瓦拉跟谁生活在一起了	切·格瓦拉
王俊凯在哪些方面有特长	王俊凯
灵魂摆渡3在哪个播放平台播	灵魂摆渡
论文的要求有哪几种	论文
黄家驹弟弟叫什么名字	黄家驹
谁教的柏拉图	柏拉图
淘宝网哪年成立的	淘宝网
一共有多少季的无耻之徒上映了	无耻之徒
hao123是哪家公司研发的商品	hao123
加拿大人用什么语言	加拿大人
1号店用什么口号励志	1号店
青岛市工商行政管理局的地点在哪儿	青岛市工商行政管理局
有多少人在澳门	澳门
第一次见到adobeillustrator是在什么时候	illustrator
花千骨的师傅是谁	花千骨
核心期刊是由什么理论得来的	核心期刊
巴黎的宗教信仰怎么样	巴黎
我不是潘金莲的拍摄地	我不是潘金莲
长征五号系列运载火箭是哪个国家的	长征五号系列运载火箭
迈克尔·乔丹的儿子叫什么名字	迈克尔·乔丹
朝鲜货币是什么	鲜货
清明上河图年代	清明上河图
人字的四角号码是多少	少
四大会计师事务所的成员	四大会计师事务所
microsoftvisualstudio的更新时间不	microsoftvisualstudio
资本的含义	资本
方大同的唱歌风格是啥	方大同
作者什么时候创作了荷塘月色	荷塘月色
中国共产党中央纪律委员会分管方向是	中国共产党
appletv售价	appletv
野子的原唱是谁	野子
锦绣未央原著叫啥	锦绣未央
于魁智属于哪个单位的	于魁智
周深把谁当偶像的	周深
新加坡写成英语是什么样的	新加坡
玛丽苏的近义词是什么	玛丽苏
皇家马德里足球俱乐部的老大	皇家马德里足球俱乐部
头条号的网站口号	头条
拉斯维加斯具体建成于哪个年代	拉斯维加斯
西伯利亚雪橇犬属于什么种群	西伯利亚雪橇犬
陈奕迅是哪个经纪人旗下的	陈奕迅
谁是现在的法国总统	法国总统
春光灿烂猪八戒的主角	春光灿烂猪八戒
中国地质大学邮编给我一下	中国地质大学
德国国歌有着怎样的名字	德国国歌
全国青少年网络文明公约提出时间	青少年
杭州一共多大面积	杭州
名侦探柯南剧场版是谁搞出来的	名侦探柯南剧场版
他是龙的色彩是怎样的	龙
大鱼海棠制作费用	海棠
贞操带的流行时期	贞操带
雅思如何用英文简单的表示	雅思
播放流媒体那个叫什么	流媒体
5·12汶川地震的名称	5·12汶川地震
名侦探柯南剧场版原作者的名字	名侦探柯南剧场版
在侠盗猎车手5之前还有一系列的哪些作品	侠盗猎车手5
王维的关键作品	王维
虎牙的定位	虎牙
为伊丽莎白谱曲的是谁	伊丽莎白
血液透析的医治方法对什么疾病最有效	血液透析
放弃我抓紧我的导演	抓紧我
vhd来自哪里	vhd
哪年有的g20峰会	g20峰会
聚丙烯的化学式是什么	聚丙烯
陈绮贞唱什么类型的歌	陈绮贞
acfun的网站口号是什么	acfun
国王与乞丐录音人员是谁	王与
青海有什么特产	青海
网盘都用了什么技术	网盘
哪位是李嘉诚的夫人	李嘉诚
mfc的使用对象都有哪些	mfc
海绵宝宝的别称叫什么	海绵宝宝
谁让美元面向大众的	大众
从你的全世界路过的长度	从你的全世界路过
strstr的评议	strstr
哪些是管理学的代表人物	管理学
琅琊榜首播是啥时候	琅琊榜
有几种托福种类	托福
喝拿铁对身体会有什么危害	身体
爱新觉罗·玄烨执政时的年号是什么	爱新觉罗·玄烨
thebeatles的曲风	thebeatles
中国主体民族有哪些	主体民族
哪位是神奇动物在哪里的编剧	神奇动物在哪里
许巍做哪些事情会很开心	许巍
ac米兰足球俱乐部的队歌	ac米兰足球俱乐部
流媒体在哪播放	流媒体
我不是潘金莲都在哪儿取了景	我不是潘金莲
谁是李菁学生	李菁
唐家三少看起怎么样	唐家三少
美丽新世界出自哪里	美丽新世界
哪个国家生产了歼-20	歼-20
荷兰的国家代码是多少	荷兰
哪里是济州岛的首府	济州岛
聚丙烯的化学式	聚丙烯
清湖上河图什么时候画的	上河图
提起会计就想到了什么院系	会计
诸葛亮辞世的日子	诸葛亮
老友记的主题曲名字	老友记
追梦赤子心被冠以什么奖项	追梦赤子心
帝霸小说写到哪了	帝霸
亚洲足球锦标赛的举办位置	亚洲足球
纳兰性德的字号	纳兰性德
什么时候开始筹建龙泉寺的	龙泉寺
哪些活动是盂兰盆节会做的	盂兰盆节
无耻之徒放出来几季	无耻之徒
哪种音乐风格是陈绮贞的	陈绮贞
加利福尼亚大学伯克利分校的校歌是哪首	加利福尼亚大学伯克利分校
vlookup函数的作用	vlookup函数
五星连珠会造成什么影响	五星连珠
霍建华个子是多高	霍建华
微软的主要成果	微软
蓝莓的功用	蓝莓
墨子的民族是什么	墨子
丁墨在哪儿	丁墨
唐朝的钱是什么样的	唐朝
第一台电脑的问世时间	第一台电脑
高铁每小时运行的公里数	小时
中国知网的官网么	中国知网
黑豹乐队的鼓手是谁	黑豹乐队
bmi指数的简要名称	bmi指数
发射神舟十一号飞船的地方是哪里	神舟十一号飞船
大熊猫的学名	大熊猫
海洋的体积	海洋
websocket的意思	websocket
梦想的声音在什么时间段开播	梦想
狗带怎么解释	狗
市净率的计算公式是什么	市净率
孤独的英语说法	孤独
什么数字组合是中国地质大学的邮编	中国地质大学
看生死狙击最关键的都是些什么内容	生死狙击
波雅·汉库克喜欢的人是谁	波雅·汉库克
snh48的行政总裁叫什么	snh48
cvt是怎样工作的	cvt
怎么表示向量积	向量积
acfun的网站口号	acfun
侠盗猎车手5是哪部作品的衍生系列	侠盗猎车手5
那个雪鹰领主讲的是谁的故事	雪鹰
天津当地人都说什么话	天津
要给中国地质大学写信填什么邮编	中国地质大学
神奇动物在哪里的作者	神奇动物
arduino的创始人是谁	arduino
黄致列什么歌最好听	黄致列什么歌
什么队里的董力	董力
谁创作的饥荒	饥荒
宁夏有哪些个大学	宁夏
身体乳具体是来干嘛的	身体乳
蒙面唱将猜猜猜这个节目是在哪个国家录制的	猜猜猜
苹果的ceo么	苹果
武汉的地理坐标是多少	武汉
谁拍的芈月传	芈月传
microsoftofficevisio的根本性质	microsoftofficevisio
node.js的首发时间	node.js
景甜在哪上的学	景甜
无题是什么文体	无题
皇后大道东的曲目数量是多少	皇后大道东
无耻之徒讲了几季的故事	无耻之徒
苏轼哪年去世的	苏轼
铁凝究竟是哪个姓氏的	铁凝
海词词典是哪年写的	海词词典
金牛座出生日期是几月几号到几月几号	金牛座
关于帝霸的小说完成状态	帝霸
谁是盗墓笔记的监制人	盗墓笔记
什么地方是迪士尼的中心	迪士尼
在什么地区流传着中秋节	中秋节
上海虹桥站属于什么等级的火车站	上海虹桥站
陈绮贞都有什么类型的歌	陈绮贞
推荐几个专门能打羽毛球的地方	羽毛球
野子的原唱叫什么	野子
巴黎哪个宗教人数最多	巴黎
陈绮贞爱唱什么样的歌	陈绮贞
伏地魔活了多久	伏地魔
www里面包含了哪些定义	www
金牛座时间	金牛座
张国焘去世的地方	张国焘
请回答1988有几集	请
华为技术有限公司初期建立于多会儿	华为技术有限公司
幽门螺杆菌属于哪类生物	幽门螺杆菌
微微一笑很倾城出品公司的全名	微微一笑很倾城
g20峰会哪年开始有的	g20峰会
sumif函数的表达式	sumif函数
牙套对人有什么好处	牙套
英语i在拉丁文里面的排序是怎样的	英语
三味线是哪个专辑里的歌曲	三味线
奔跑吧兄弟谁给他们录音的	奔跑吧兄弟
顺丰速运的成立地点在哪里	顺丰速运
杨永信是男的女的	杨永信
瑜伽节什么时候过	瑜伽
哪个歌手唱的我要你	手
哪天开拍的寒战２	开拍
中国梦的概念是什么	中国梦
神司马懿的技能是什么	神司马懿
苏州的总人数	苏州
第一次世界大战称为什么	第一次世界大战
美丽的春天歌手姓名	美丽的春天
杜鹃专长	杜鹃
黄景瑜的生日	黄景
介绍庐山土地面积	庐山
南京地铁3号线开通日期	南京地铁3号线
里番的意思	里番
中南海方位	中南海
美人鱼学名	美人鱼
北京故宫具体有多大面积	北京故宫
检察官在什么地方上班	检察官
克里斯汀·斯图尔特的基因	克里斯汀·斯图尔特
匈牙利的核心银行叫什么	匈牙利
酷儿身高体重是多少	酷儿
痘印表现为什么	痘印
是谁谱曲了欢乐颂	欢乐颂
bigbang做什么的	bigbang
ncbi在哪个国家里	ncbi
是谁设计出了php	php
历经了多久巴黎圣母院才被建造出来的	巴黎圣母院
瑞士的政治体制	瑞士
一加手机的屏幕大小	一加手机
颞的词语有哪些	颞
bangbangbang唱的是哪国语言	bangbang
foxmail叫什么名字	foxmail
江苏有省会么	江苏
无题属于什么文体	无题
谁是皇家马德里足球俱乐部的队长	皇家马德里足球俱乐部
举重妖精金福珠的开播时间	妖精
辞职信的重要因素	辞职信
那些花儿的其他歌手	那些花儿
丢番图与世界告别的日子是哪天	丢番图
喝大麦茶的好处都有哪些	大麦茶
编花篮的作曲	编花篮
寒战2哪天开拍	寒战2
三体的另一种叫法	三体
侠盗猎车手5的第一部是	侠盗猎车手5
绝命毒师获得奖项是什么	绝命毒师
血液透析治疗的疾病是什么	血液透析
陈氏太极拳流传国家	陈氏太极拳
唐家三少的外形	唐家三少
后来原曲	后来
陈氏太极拳由什么国家流传下来	陈氏太极拳
解释一下嬗变的意思	嬗变
滨崎里绪在何时正式与人们见面的	滨崎里绪
字典上怎么解释资本	字典
朴槿惠的婚姻状况你了解	朴槿惠
谁出演过赵敏	赵敏
北京南站隶属哪个铁路局管辖	北京南站
半月板会生病都是因为	半月板
白茶哪个产地好	白茶
苏小妹的爸爸是	苏小妹
王嘉尔的家庭成员都有谁	王嘉尔
是在哪天开通的南京地铁3号线	南京地铁3号线
澳大利亚的大城市有哪些	澳大利亚
怎么翻译孤独	翻译
厦门土话叫什么	厦门
因为哪家公司我们见到了microsoftvisualc++	microsoftvisualc++
seo的诞生时间是多会儿	seo
纽约中央公园用了多大的地	纽约中央公园
哪年创作的内战的预兆	内战的预兆
项羽的族群	项羽
洛天依的配音演员	洛天依
lotto的歌曲都是哪国语言	lotto
谁是走着走着就散了的混音	走着走着就散了
景甜是从哪里毕业的	景甜
颞相关的词语	颞
一帘幽梦有谁翻唱过	一帘幽梦
固态硬盘的组成部件还有哪些	固态硬盘
完美世界是通过哪个出版社出版的	完美世界
摩洛哥人口统计	摩洛哥
s原子的相对质量是多少	原子
甄嬛恋人的名字是	甄嬛
张艺兴是哪个组合的成员	张艺兴
巴厘岛有哪些地方语言	巴厘岛
ysl官网是什么	ysl
哪个峰是长白山脉的主峰	长白山脉
心理健康状态	心理健康
x射线有什么特殊的地方	x射线
百度糯米在什么地方	百度糯米
台湾电影金马奖成立最初是什么时候	台湾电影金马奖
蔡国庆的所属单位	蔡国庆
microsoftonenote的发布情况	microsoftonenote
二八定律换种说法	二八定律
澳大利亚有哪些世界著名的城市	澳大利亚
供应链的根源是什么	供应链
哆啦a梦的连载杂志	哆啦a梦
科学的解释猫的类别	科学
济州岛的行政中心	济州岛
一般葡萄都种在多少海拔内	葡萄
立体电影画面是什么样的	立体电影
与新闻意思一样的词语有哪些	新闻
锦绣未央的指导价是	锦绣未央
尤克里里的主要材质是什么	克里
网易公司的股票代码	网易公司
庆端阳作曲人，作词人各是谁	庆端阳
最先用gopro的人是	opr
饥荒的音乐谁写的	饥荒
乌台诗案是什么时候的事儿	乌台诗案
詹天佑所在的是哪个时期	詹天佑
解释里番	解
请回答1988的集数	1988
刺客信条：大革命的主要角色	刺客信条：大革命
年轮说专辑里有多少首歌曲	年轮
参商的演唱者么	参商
哪家唱片公司签了杨幂	杨幂
smart原则在哪出现的	smart原则
牛排尝起来如何	牛排
幻城是哪年的电影	幻城
ebsco位于什么地方	ebsco
后来的原版是哪首歌	后来
鹿晗国籍	鹿晗
黑五的日期	五
澳大利亚的主要城市是什么	澳大利亚
拉布拉多猎犬存活于哪里	拉布拉多猎犬
盂兰盆节的活动	盂兰盆节
windows操作系统的奠基人都有谁	windows操作系统
怎样治疗乳腺结节	乳腺结节
端午节的吃食	端午节
microsoftofficevisio根本上是什么	microsoftofficevisio
任天堂的邮政编码	任天堂
边境牧羊犬性格	边境牧羊犬
裴秀智参加过哪些运动	裴秀智
多会儿出版的银魂	多会
3d打印是谁发明的	3d
刘诗诗多少公斤	刘诗诗
语音是由什么而来的	语音
极乐净土原文发音是什么	极乐净土
赵雷是什么风格的歌手	赵雷
小米手机5系统	小米手机5
s的相对原子质量是多少	s
们酷儿的身高体重	酷儿
秦始皇活了多少岁	秦始皇
陈绮贞音乐类型	陈绮贞
qq更气日期是多会儿	qq
七大洲里面哪个有英国	七大洲
史蒂夫·乔布斯的生母到底是谁	史蒂夫·乔布斯
名侦探柯南播到哪儿了	名侦探柯南
可乐的坏处有哪些	可乐
画江湖之不良人的配乐谁创作的	画江湖之不良人
咱们相爱吧的出品时间	相爱
怎么用英语说新加坡	新加坡
哪些报刊上有哆啦a梦的连载	哆啦a梦
胡歌是哪儿人	胡歌
pthread_cond_wait可以和什么一起搭配	pthread_cond_wait
深圳的所属地区	深圳
清明上河图有怎样的历史背景/	清明上河图
ba的原子量是什么	ba
ebsco的地址	ebsco
林俊杰的宗教	林俊杰
在什么时候拾穗者结束了生命的	拾穗者
kenarai音乐作品列表	kenarai
完美世界的出版社是	完美世界
58同城希望大家通过哪句品牌定位记住自己	58同城
双曲线离心率怎么算	双曲线
谁娶了龚琳娜	龚琳娜
bobbytinsley的歌曲风格是什么	bobbytinsley
菲德尔·卡斯特罗生于哪天	菲德尔·卡斯特罗
埃及国花是什么	埃及
sat的别称	sat
核工业404的地理位置在哪儿	核工业
ip地址怎么分类	ip地址
美国队长3的制片成本	美国队长3
cortana根据什么形象塑造出来的	cortana
谁唱的葛雷·奥特曼	葛雷·奥特曼
华为技术有限公司的成立时间	华为技术有限公司
张继科都获过什么奖项	张继科
王思聪他爸么	王思聪
幻城的上映时间	幻城
苏秦老师名字是	苏秦
关于丢番图离世的日子能告诉我	丢番图
秦始皇享年多少岁	秦始皇
哪家公司把美元发出的	哪家公司把美元发出的
谁生产制造的jira	jira
辛普森杀妻案里面的关键人物是	辛普森杀妻案
谁造成了国有企业改革	国有企业改革
金牛座日期	金牛座
谁是甄嬛的恋人	甄嬛
机械键盘的优势有哪些	机械键盘
北京故宫多少平方	北京故宫
唐家三少什么样子	唐家三少
治疗乳腺结节的方法有什么	乳腺结节
谁才是雪鹰领主里的主人公	领主
熊猫tv又名	熊猫
中国式关系哪个播放器能看	中国式关系
演员用英文怎么说	演员
白茶主要产地主要有哪些地方	白茶
为冰菓进行制作、加工的是谁	为冰菓进行制作、加工
五官的含义	五官
在海南可以看到哪些高等学校	海南
中国新歌声的主持人	新歌
在盂兰盆节都会看到什么活动	盂兰盆节
小幸运用中文怎么说	幸运
詹天佑所处时期	詹天佑
闪电侠的能力都能干什么	闪电侠
nba何时诞生的	nba
霍建华多高的个	霍建华
梁海玲的姓名	梁海玲
latex是什么的重要分支	latex
贞子的男朋友是	贞子
编花篮作曲者是谁	编花篮
qq空间有哪些版本	qq空间
诗经小名是什么	诗经
陈奕迅是谁捧红的	陈奕迅
莫度男爵的师傅	男爵
那个ba的原子量你知道它的值	ba
匈牙利最重要的银行是	匈牙利
歌诗达邮轮走的什么路线	歌诗达邮轮
3d肉蒲团之极乐宝鉴的出品人	3d肉蒲团之极乐宝鉴
一帘幽梦都有谁唱过	一帘幽梦
宋小宝的师傅	宋小宝
湖北哪些大学很出名	湖北
哪些著名的大学在湖北	哪些著名的大学在湖北
顺丰速运是哪里成立的	顺丰速运
我想去融资给我介绍几个方法	我想去融资给我介绍几个方法
巴黎教徒人数最多的宗教是哪个	巴黎
西伯利亚雪橇犬是什么种类的	西伯利亚雪橇犬
翻译冰与火之歌的是	冰与火之歌
拾穗者的去世日期	拾穗者
谁得到了木心的亲传	木心
引号该怎么用	引号
尤克里里是什么材质做的	克里
双鱼座有什么特色的地方	双鱼座
铳皇无尽的法夫纳是谁的作品	铳皇无尽的法夫纳
老舍字什么	老舍
valve有多少员工么	valve
易烊千玺的星座	易烊千玺
大麦茶有哪些好处	大麦茶
php的发明者	php
中国旅游著名景点	中国旅游
蓝光属于什么领域	蓝光
林俊杰信仰的宗教是	林俊杰
余罪一集多长时间	余罪
一加手机的显示屏大小	一加手机
拳皇13是什么画面	拳皇13
美国队长3的制片成本多少	美国队长3
谁把心经翻译过来的	心经
择天记的首发网站	择天记
unity3d是哪个公司的研究成果	unity3d
纸牌屋的imdb编号是多少	纸牌屋
辞职信的主要元素	辞职信
flowerdance出自哪里	flowerdance
xamarin你会读	xamarin
顺丰速运是什么地方创办的	顺丰速运
华山的长度是	华山
秘鲁都用什么时区	秘鲁
nba什么时候有的	nba
数据结构的解释	数据结构
电磁波的危险物质是什么	电磁波
纽约中央公园有多大的地	纽约中央公园
梦田的合声是谁写的	梦田
cfr是什么领域的术语	cfr
包皮归哪个属	包皮
ssid有什么用途	ssid
国歌的歌曲曲风	国歌
国家学生体质健康标准的主旨	国家学生体质健康标准
玻璃的主要成分	玻璃
纽约中央公园建成占用了多少地	纽约中央公园
佛山都有哪些有名气的学府	佛山
詹天佑是什么时期出的人才	詹天佑
那个刘慈欣是干什么的	刘慈欣
皇家马德里足球俱乐部的带队	皇家马德里足球俱乐部
虎牙位置	虎牙
向量积的公式	向量积
拍拍贷在哪里办公	拍拍贷
全权负责城寨英雄剧本统筹的是谁	城寨
李晨的对象是	李晨
在何时开始造天安门的	天安门
什么样的原理造出的云盘	云盘
北京南站的隶属铁路局	北京南站
易烊千玺星座不	易烊千玺
劳尔·卡斯特罗的哥哥是谁	劳尔·卡斯特罗
什么技术存在于网盘里	网盘
多少平方是比亚迪股份有限公司所拥有的	比亚迪股份有限公司
鸡蛋果的属类是什么	鸡蛋果
秦时明月之君临天下有什么其他名称	秦时明月之君临天下
曹操的谥号是什么	曹操
孙悟空生在哪	孙悟空
张家界的机场叫什么	张家界
紫霞仙子的姐姐叫什么	紫霞仙子
担仔面的配方	担仔面
那个mit许可证在哪年哪月哪日发布的	mit许可证
appletv多少钱	appletv
心理健康有着怎样的状态	心理健康
民族乐派是哪个年代的	民族乐派
r语言有什么功能	r
五四运动推动了什么发展	五四运动
是谁出品的微微一笑很倾城	微微一笑很倾城
从麻省理工学院这座名校里出来的名人有哪些	麻省理工学院
ds耗油多少	ds
qq空间的版本	qq空间
任天堂的邮编是哪几个阿拉伯数字	任天堂
讲下无花果的门类知识	无花果
多少公里是高铁的时速	少
海绵宝宝的其他译名叫什么	海绵宝宝
鹿晗是哪国的	鹿晗
大数据的提出人是	大数据
哪些是奚梦瑶的爱好	奚梦瑶
非洲的原本含义	非洲
matlab代表什么	matlab
李易峰粉丝的名字是	李易峰
云画的月光拍摄地点	云画
生死狙击是什么主题的	生死狙击
第一台计算机的建造日期	计算机
名侦探柯南：纯黑的恶梦的首映时间	名侦探柯南
英制螺纹都有哪些规格	英制螺纹
谁是陈奕迅的经纪人	陈奕迅
李白其实叫什么	李白
google有着怎样的公司名称	google
六法论是哪儿的	六法论
谍影重重分级是什么	谍影重重
去朝鲜要用什么钱	朝鲜
阿衰最喜欢干的事是	阿衰
什么地方有日本三大妖怪	日本三大妖怪
身体乳具体是怎么使用	身体乳
呼斯楞唱歌的风格	呼斯楞
聚乙烯在几度可以称之为沸点	聚乙烯
天宫一号的总长为多少	天宫一号
电影美国队长3的制作成本是多少	美国队长3
是什么推动了国有企业改革	国有企业改革
内容分发网络的基础是什么	内容分发网络
blackpink从事的是什么	black
京韵大鼓什么地区流行	京韵大鼓
应用spring的一般范围是什么	spring
什么样的人被称为管理学的代表人物	管理学
解释下site是什么	ite
王家卫和谁在一起生活	王家卫
电子商务的要义为何	电子商务
庄子因什么作品而留名于后世	庄子
一般梅毒传播方式是什么	梅毒
改革开放有啥作用	改革开放
玛丽苏近义词	玛丽苏
联想集团的国别	联想集团
dns劫持会产生什么	dns劫持
加利福尼亚大学伯克利分校唱的校歌是什么	加利福尼亚大学伯克利分校
拉希奥现在在哪儿	拉希奥
机器学习涉及的领域	机器学习
兔子是什么动物	兔子
说几个南京有名的地方	南京
什么叫动漫	动漫
ra485长度为	485
中国传统节日流行地方	中国传统节日
哪座峰被誉为长白山脉的主峰	长白山脉
张宇拜谁为师的	张宇
北京南站属于哪个铁路局	北京南站
美丽的春天原唱是谁	美丽的春天
晓得vlookup函数的功能不	vlookup函数
中国国民党的建党时间	中国国民党
1024这天要过的是什么节日	1024
杨幂刘恺威婚礼中都有什么场地	杨幂刘恺威婚礼
云盘是怎么做出来的	云盘
黄致列最出名的作品	出名
中国地质大学的邮政编码是多少	中国地质大学
放弃我抓紧我是哪位导演的作品	抓紧我
拉布拉多猎犬都在何地有	拉布拉多猎犬
冬至在哪个季节里	冬至
你曾这样问过的翻唱者名字	曾
sat的其他说法是什么	sat
龙珠直播的主办单位是什么	龙珠
姜思达的母校是什么学校	姜思
9·11事件的事发地么	9·11事件
路西法是哪本书里的	路西法
哪四个数字是人这个字的四角号码	数字
无耻之徒出了几季	无耻之徒
立体电影是什么	立体电影
ptc由什么组成的	ptc
你懂bootstrap的归类不	bootstrap
哪里有僵尸	僵尸
岳云鹏一般和谁合作的比较多	岳云鹏
我的奇妙男友的编剧	男友
陈赫的口头禅是什么	陈赫
幻灯片版式是被放在哪里应用的	幻灯片
大学里的会计专业是属于哪个系别的	会计专业
直男癌这个词是怎么来的	直男癌
木村拓哉有着怎样的性格	木村拓哉
维生素a的外在状态	维生素a
bangbangbang歌曲语言是什么	bangbang
毛泽东逝世日期	毛泽东
youtube的员工数量是多少	youtube
赵丽颖的小名	赵丽颖
宇宙直径有多长	宇宙
血液透析还能治疗的疾病是什么	血液透析
林中鸟是被谁创作出来的	林中
林俊杰的宗教是什么	林俊杰
你觉得pthread_cond_wait与什么搭配合适	pthread_cond_wait
联想集团属于哪个国家	联想集团
拉布拉多猎犬的分布区域	拉布拉多猎犬
去加利福尼亚玩儿要去哪儿	加利福尼亚
深圳地铁11号线什么时候通车	深圳地铁11号线
江户川柯南是哪个人表演的	江户川柯南
荨麻疹的一般发病部位	荨麻疹
萨尔的骑行动物是什么	萨尔
十二道锋味第二季制作方是谁	十二道锋味
h.264属于什么	h.264
心理健康的状态分别是什么	心理健康
景甜毕业院校	景甜
去海南念高等学校的话都有哪些可以选择	高等学校
黄河长度是	黄河
爱奇艺外文名是啥	爱奇艺
朴槿惠的婚姻生活怎么样	朴槿惠
mfc面对的对象是谁	mfc
林中鸟的作者是谁	林中
哪种花是埃及的国花	埃及
ncbi存在于哪个国家	ncbi
云画的月光在哪儿取的景	云画
神司马懿的技能有哪几种	神司马懿
acl的规则	acl
张国焘去世的地点是哪里	张国焘
鹿晗国籍不	鹿晗
sat的其他说法	sat
由谁进行了欢乐颂的音乐创作	欢乐颂
瑞士的政治制度是什么	瑞士
区块链的特点	区块链
自传是谁的	自传
研究员是干什么的	研究员
辛普森杀妻案里面都有哪些	辛普森杀妻案
波雅·汉库克喜欢哪个人	波雅·汉库克
团歌是谁作曲的	是谁
北京南站归哪里管辖	北京南站
谁是章鱼哥的朋友	章鱼哥
英制螺纹直径有几种	英制螺纹
路西法出处	路西法
bobbytinsley的演唱风格是什么	bobbytinsley
庄子的什么作品最拿得出手	庄子
有多少人生活在北魏	北魏
s.t.的汉语意思是什么	s.t.
五位一体的出处	五位一体
羊肉的味道	羊肉
迪拜多大	迪拜
李相赫的其他称呼有哪些	李相
裴秀智喜欢哪些运动	裴秀智
演员英语	演员
犹太人名人	犹太人
哪些是哈利·波特的名称	哈利·波特
acl的固定准则是什么	acl
洛阳的高等院校具体有什么	洛阳
什么运动项目是林丹从事的	项目
上海迪士尼乐园的气候	上海迪士尼乐园
史蒂夫·乔布斯的母亲叫什么	史蒂夫·乔布斯
路西法来自于哪儿	路西法
博柏利是一种什么品牌	博柏利
颐和园什么时间段开	颐和园
1989的播放时长	1989
长城在哪儿么	长城
罗敏庄跟谁生活在一起	罗敏庄
威风堂堂的曲子是谁写的	威风堂堂
史蒂夫·乔布斯的妈妈	史蒂夫·乔布斯
谁是腾讯的总裁	腾讯
黄山是几a级景区	黄山
高桥李依出道年份是	李依
上海虹桥站属于什么级别的车站	上海虹桥站
pmo能干什么	pmo
使用借记卡的方法有哪些	借记卡
白茶产地哪边的最好	白茶
哪里发射了神舟十一号飞船的	神舟十一号飞船
黑洞直径	黑洞
在什么日子发布的mit许可证	mit
在哪个专辑里听到的丑八怪	丑八怪
老舍还叫什么	老舍
什么表现是抑郁症经常会有的	抑郁症
姚明的闺女	姚明
比特币的类型	比特币
赵一荻是谁老婆	赵一荻
microsoftonenote发行状态	microsoftonenote
灵魂摆渡3在线播放平台	灵魂摆渡
火影忍者剧场版是谁搞出来的	火影忍者剧场版
路西法起源是	路西法
谢霆锋的儿女姓名	谢霆锋
007喜欢什么	007
美元最初由谁发行的	最初
核心期刊的理论是什么	核心期刊
缅甸的大小	缅甸
法国最近谁当总统	法国
多少成本投资了投名状	投
波风水门的孩子是哪位	波风水门
萌萌哒天团创办地点在哪里	萌萌哒天团
哪天圣诞节不	圣诞节
贝加尔湖的水到底有多高	贝加尔湖
事实上microsoftofficevisio是什么	microsoftofficevisio
加拿大的语系是什么语系	加拿大
双曲线离心率	双曲线
龙泉寺什么时候开始建设的	龙泉寺
瑞士的政治制度	瑞士
谁是火影忍者剧场版的作者	火影忍者剧场版
git的发音	git
法医秦明都是哪个国家演的	法医
flowerdance所属哪张专辑	flowerdance
在哪年拾穗者与世界告别的	拾穗者
volte代表什么	volte
二八定律你还可以怎么说	二八定律
李世民的庙号	李世民
可行性研究报告的标准	可行性研究报告
阿特拉斯的相关事情	阿特拉斯
杨洋身高有多少	杨洋
一加手机的屏幕有多大	一加手机
如何评价imaginedragons	imaginedragons
伊丽莎白是哪个人写的	伊丽莎白
第一个发现正态分布的是谁	正态分布
尊重的含义	尊重
什么状况是农业电子商务正处于的	电子商务
酉阳杂俎是什么朝的作品	酉阳杂俎
什么地方会长红薯	红薯
方便面从什么时候出现的	方便面
火影忍者剧场版原作者的名字	火影忍者剧场版
数据库代表什么	数据库
在盂兰盆节大家都有什么活动	盂兰盆节
内战的预兆的创作时间	内战的预兆
报一下qq空间的版本数	qq空间
怎么解释尊重	尊重
股票型基金	股票型基金
西游记原著到底是什么体裁	西游记
张起灵的爷爷是谁	张起灵
巴厘岛用什么语交流	巴厘岛
五官指什么	五官
唐舞麟的母亲是哪位么	唐舞
帝霸小说现在的状态是什么	帝霸
克里斯汀·斯图尔特的血统	克里斯汀·斯图尔特
聚丙烯标准的化学表达式	聚丙烯
ssid应用在哪里了	ssid
microsoftoffice的最新版本是什么	microsoftoffice
甄嬛最后喜欢的是谁	甄嬛
唐朝的钱	唐朝
ac米兰足球俱乐部的队歌是什么	ac米兰足球俱乐部
法国现任总统	法国
w-inds.主唱的名字是什么	w-inds.
你能科学的告诉我猫是属于哪类动物	猫
莫文蔚崇拜谁	莫文蔚
加利福尼亚大学伯克利分校的校歌	加利福尼亚大学伯克利分校
无耻之徒的季数	无耻之徒
风信子的花语是什么	风信子
可口可乐的副作用有哪些	可口可乐
走向共和向哪发行的	走向共和
会计的系别	会计
黑羽的英文	黑羽
林中鸟的作者叫什么名字	林中
追梦赤子心赢了哪个奖	追梦赤子心
谁是宋小宝的师傅	宋小宝
选举人票为何产生	选举人票
圆明园的门票	圆明园
谁唱的上瘾	上瘾
赵一荻的丈夫是谁	赵一荻
萨尔的坐骑	萨尔
市净率的计算方法	市净率
十二星座代表着什么	十二星座
苏轼的逝世时间	苏轼
如何用英文念黑羽	黑羽
威尼斯这地方有什么好玩好吃的东西	威尼斯
公主头的分类	公主头
s.t.的中文是什么	s.t.
梦想的声音播出的具体时间是多会儿	梦想
三里屯什么时间开放	三里屯
陈绮贞的音乐是什么风格	陈绮贞
snh48由谁掌管的	snh48
windows.old在哪儿么	windows.old
海词词典创始于哪年	海词词典
ba元素的相对原子质量是多少	ba
扮演过赵敏的演员都有哪些	赵敏
马来西亚的主要城市	马来西亚
中二病的反义词	中二病
路西法的由来	路西法
一帘幽梦还有哪些歌手唱过	一帘幽梦
王俊凯最会干什么	王俊凯
b族维生素的科学使用方法	b族维生素
sleep函数的用法有哪些	sleep函数
ppap在中国翻译成什么名字	ppap
宋小宝拜师于谁	宋小宝
谁是沙溢的老婆	沙溢
谁是画江湖之不良人的音乐制作人	画江湖之不良人
江户川柯南演员是谁	江户川柯南
拾穗者什么时候归西的	拾穗者
一人我饮酒醉的歌曲时长	一人
位于湖北能就读哪些名校	湖北
摩尔斯电码发明人	摩尔斯
南北朝一共有过几个首都	南北朝
中国地质大学的邮政编码	中国地质大学
艾吉奥的子孙都叫什么	艾吉奥
奇妙能力歌的填词	奇妙能力歌
163是啥	163
威尼斯有哪些特别的好玩意儿	威尼斯
蓝光的领域有哪些	蓝光
陈绮贞的音乐是什么风格的	陈绮贞
中国国家女子排球队英文怎么说	中国国家女子排球队
刘备的字号	刘备
章鱼哥朋友叫什么	章鱼哥
许巍做什么会很享受	许巍
关于戚继光的故事有哪些	戚继光
用英文说万圣节	万圣节
从哪儿找windows.old	windows.old
绘画的主要因素有哪些	绘画
如何把扭矩的数值计算出来	数值计算
blackpink平时是做什么工作的	black
铁凝在古代的姓氏是什么	铁凝
青云志制片地区在哪	青云志
汉江的范围	汉江
张学良的籍贯不	张学良
巴黎圣母院开始到完工经历了多久	巴黎圣母院
钟丽缇会几门外语	钟丽缇
非洲的原本含义	非洲
007喜欢什么样的马天尼	007
塞卡病毒常见病因是什么	病毒
加拿大到底使用什么语系	加拿大
中元节节日时间	中元节
消防宣传日当天有什么活动	消防宣传日
英文名的举例有什么	英文名
胡歌的老家	胡歌
抑郁症常见的症状	抑郁症
辞职信有哪些重要的部分	辞职信
引号的意义	引号
中东的主要宗教是什么	中东
机械键盘的优势有哪些	机械键盘
哪位写的模特	位
动漫的定义有哪些	动漫
周杰伦的床边故事专辑是什么语言	床边故事
巴霍巴利王制造成本多少钱	巴利
谁是3d肉蒲团之极乐宝鉴的出品人	3d肉蒲团之极乐宝鉴
博柏利是哪种类别的品牌	博柏利
s的相对原子质量数值是多少	s
关之琳是谁的好友	关之琳
金木研哪天过生日么	金木研
个人所得税税率表怎么算	个人所得税税率表
bilibili的创始人	bilibili
表情符号是什么样的文化	表情符号
梦想的声音的时间是什么时候	梦想
四分位数的示例有哪些	四分位数
孙悟空来自哪	孙悟空
聚乙烯的标准沸点是几度	聚乙烯
哪家公司帮杨幂进行音乐制作的	杨幂
美国在哪个大洲	美国
转义字符还有什么别的称呼	转义字符
绝世唐门是什么类型的书籍	绝世唐门
谁叫唐三岳母	唐三
可不可以说沙溢的出生地在哪儿	可不可以
bmi指数的其他名称有什么	bmi指数
齐鲁制药有限公司有多大地盘	齐鲁制药有限公司
什么样的画质是游戏人生所具备的	游戏人生
杜隆坦的好友是谁	杜隆坦
柳岩对哪个动物有好感	柳岩
国家学生体质健康标准的主要思想	国家学生体质健康标准
请回答1988集数不	请
刘慈欣坐到了什么位置上	刘慈欣
十二道锋味第二季的制作公司是谁	十二道锋味
张艺兴的组合名称	张艺兴
去什么地方能看到瓜德尔港	瓜德尔
天气的定义是什么	天气
要用到问号的句式有哪些	问号
资产负债表指什么	资产负债表
悦的音标怎么写	悦
t是由谁演唱的	t
lachata专辑里有哪些歌曲	lachata
bmi指数还有什么简称	bmi指数
原来你还在这里的台词语种是什么	原来你
spring的应用范围多大	spring
陶瓷的原料中含有什么	陶瓷
绘画的主要因素	绘画
朋克起源的年代	朋克
拾穗者在哪年逝去的	拾穗者
识汝不识丁的格调	识汝不识丁
闪电侠的能力有什么用	闪电侠
给我解释下site	ite
angelababy的生肖是什么	angelababy
适合打羽毛球的场地都有哪些	羽毛球
裴秀智擅长的运动是什么	裴秀智
方大同的唱歌特点	方大同
任天堂的邮政编码	任天堂
qq邮箱的外文名称	qq邮箱
哪天拍摄的魔兽	魔兽
一般种红薯都去什么地方	红薯
介绍几首五月天的代表作	五月天
谁开发了qq音乐	qq音乐
最初创办台湾电影金马奖的时间	台湾电影金马奖
微微一笑很倾城的制作商是谁	微微一笑很倾城
抑郁症的常见症状	抑郁症
律政强人的编剧	强人
pdca循环的意思	pdca循环
上海虹桥国际机场的占地面积	上海虹桥国际机场
唐纳德·特朗普对什么极其信仰	唐纳德·特朗普
中国好声音第五季的节目类型是什么	中国好声音第五季
谁是伊万卡·特朗普的老公	伊万卡·特朗普
ig老板是什么人	ig
刊行了金瓶梅的公司叫什么	金瓶梅
蔡依林的专辑购买量有多少	蔡依林
ip地址的类型	ip地址
熊猫烧香的创作者	熊猫烧香
如何用国际标准编号找出如果蜗牛有爱情	标准编号
iphone6有几种颜色	iphone6
bilibili的创办人	bilibili
对数函数的特性	对数函数
后来的我们mv是谁导演的	后来的我们
莫文蔚崇拜的对象	莫文蔚
maven的根本性质	maven
snh48最高行政官是谁	snh48
mfc服务的群体有哪些	mfc
萨尔的坐骑是什么	萨尔
辐射避难所的游戏下载地址	避难所
谁可以代表av女忧	av
金瓶梅是哪个公司发行的	金瓶梅
啥时候泰勒·斯威夫特进的娱乐圈	泰勒·斯威夫特
极限挑战的播出状态	极限挑战
景甜来自哪个大学	景甜
跳蚤之歌的作曲	跳蚤之歌
搜狗的主办单位	搜狗
计算得出月球的离心率为多少	得出
谁操作了冰菓的拍摄	冰菓
58同城的品牌定位	58同城
sktelecomt1的队名英文是什么	elecom
谁发行的windows10	windows10
谁给天龙八部投资的	天龙八部
搜什么地址是复旦大学的位置	搜
宋仲基的粉丝叫啥不	宋仲基
新陈代谢的意思	新陈代谢
海词的作用	海词
酷儿身高体重是	酷儿
燕麦的毒性	燕麦
重庆是南方么	重庆
洋葱的做法	洋葱
三毛的爱人	爱人
云盘原理是什么	云盘
blackpink的职业	black
湿度专业	湿度
白茶的主要产地在哪里	白茶
写字板还能去指代什么	写字板
哪些人是windows操作系统的创始者	windows操作系统
甄嬛的恋人具体是	甄嬛
什么组成了太岁	太岁
云画的月光跟哪儿拍的	云画
铁凝姓什么	铁凝
斯里兰卡国土面积	斯里兰卡
大熊猫的其他名字	大熊猫
内科的医疗方法有什么	内科
陈赫一天到晚爱说什么	晚爱
匈牙利的核心银行叫什么	匈牙利
海绵宝宝的别称是什么	海绵宝宝
一拳超人原作	一拳超人
微软的主要产品有哪些	微软
蒙面唱将猜猜猜这个节目的录制国家	猜猜猜
马云的经历有哪些	马云
centos的价格	centos
美丽新世界从哪里而被人们所熟知的	美丽新世界
完美世界的出版社是哪儿	完美世界
五月天主要因哪些歌曲被人们所熟知	五月天
蒋雯丽的男人叫什么	蒋雯丽
一帘幽梦还有谁唱过	一帘幽梦
乌台诗案的历史时期是什么时候	乌台诗案
ssid在哪里用	ssid
磁力链接的领域	磁力链接
windowspowershell是通过什么平台运行的	windowspowershell
类似滕王阁序这种文学作品都统一称为什么	滕王阁序
哪个城市有瓜德尔港	瓜德尔
柏拉图是谁的学生	柏拉图
六味地黄丸的作用么	六味地黄丸
谁能告诉我哪个是王思聪他爹	王思聪
白茶产自哪里	白茶
引号的作用	引号
3d打印的发明人是谁	3d
hash的翻译	hash
李小龙子女的名字	李小龙
appletv值多少	appletv
microsoftonenote的发行已经达到哪个阶段了	microsoftonenote
未央宫建筑拥有多少面积	未央宫
北京南站属于哪个铁路局	北京南站
熊猫烧香是谁的作品	熊猫烧香
梅毒是怎样传染他人的	梅毒
王健林的妈妈是谁	王健林
西部世界的主演	西部世界
歌剧魅影的词作者	歌剧魅影
滨崎里绪的出道年份	滨崎里绪
辅酶q10的化学式	辅酶q10
谁监制的古剑奇谭	古剑奇谭
湖北以哪些大学而著称	湖北
嬗变的解释是什么	嬗变
英国是哪个洲的	英国
马云都有哪些经历	马云
哪里因瓜德尔港而著称	瓜德尔
三体还叫做什么	三体
lotto的专辑都是什么语言	lotto
帝霸小说进度如何	小说
英雄联盟是什么类型的游戏	英雄联盟
梁海玲的名字	梁海玲
做了jira的公司叫什么	jira
里番怎么翻译	里番
是谁创作了神印王座	神印王座
灵能百分百被哪家网站连载的	灵能百分百
贞子的恋人是谁	贞子
痰是由什么变的	痰
androidstudio的更新时间	androidstudio
sat是什么意思	sat
w-两个世界上映时间	上映
ssid的主要目的	ssid
sktelecomt1英文表达	elecom
赵云所处的时代是	赵云
谁是喜欢你的原唱	喜欢你
1024是什么日子	1024
可见光的速度一般达到了多少	可见光
林中鸟是经谁的手创作的	林中
hash啥意思	hash
有谁唱过父亲	父亲
加利福尼亚州出名地方有哪些	加利福尼亚州
在多少海拔内适合养葡萄	葡萄
潘金莲生活在什么时期	潘金莲
内容分发网络基础	网络基础
陈思诚属什么的	陈思诚
大熊猫有多少名字	大熊猫
爱新觉罗·玄烨的名号是什么	爱新觉罗·玄烨
163邮箱有什么作用	163邮箱
聚乙烯的沸点到底有多高	聚乙烯
宋智孝的属相是什么	宋智孝
什么庙号是李世民的	李世民
mit许可证的发布日期是哪天	mit许可证
干什么是张国荣的爱好	张国荣
犬儒主义愿意是	犬儒主义
des的体系	des
乌台诗案的历史时期	乌台诗案
windows10被哪家公司发出的	windows10
直男癌这个词语是怎么出来的	直男癌
当归的种属	当归
四分位数的例子	四分位数
谁是歼-20的所有国	歼-20
灰姑娘与四骑士是哪国话	四骑士
心理健康状态是什么	心理健康
哪个平台播我们的少年时代	少年时代
洋葱具体要怎么做	洋葱
三里屯是全天开放	三里屯
求苏联国家领袖姓名	苏联
舒淇的性格优势有哪些	舒淇
堂吉诃德的曲是谁写的	堂吉诃德
李晨的女友	李晨
无耻之徒最后一季是哪季	无耻之徒
谁是蓝胭脂她爹	胭脂
rename在什么地方能用到	rename
关于表情符号的阐述有哪些	表情符号
中央电视台可以覆盖那些地方	中央电视台
李煜出生时间	李煜
罗永浩的生日是哪天	罗永浩
博柏利是个什么样的品牌	博柏利
ig老板	ig
三里屯在什么时间开放	三里屯
microsoftonenote现在处于哪个阶段了	microsoftonenote
五证合一相近的词语	合一
研究员的工作是哪些方面	研究员
林俊杰的宗教信仰是哪个	林俊杰
哪个院系有会计	会计
重庆所属地区叫什么	重庆
全国青少年网络文明公约提出日期	青少年
你看你看月亮的脸发行商是谁	你看你看月亮的脸
深圳地铁11号线的发车时间具体是什么	深圳地铁11号线
追梦赤子心拿走的那个奖叫什么	追梦赤子心
加利福尼亚州什么地方最出名	加利福尼亚州
iphone6s是哪家公司的	iphone6s
哪些名人是犹太人	犹太人
有多少土地是拙政园的	拙政园
赵一荻嫁给了哪个人	赵一荻
哪年泰勒·斯威夫特出道了	泰勒·斯威夫特
谁是faded的原唱	fad
自动关机命令是哪个系统里的	自动关机命令
六西格玛的含义	六西格玛
五位一体来源于十八大	五位一体
中国旅游的地方哪里很好玩	中国旅游
庆端阳的词、曲作者是谁	庆端阳
奔跑吧兄弟的录音	奔跑吧兄弟
林中鸟是谁编写词曲的	林中
搜狗的母公司	搜狗
你都在盂兰盆节干些什么	盂兰盆节
蒋雯丽她老公你认识不	蒋雯丽
悦的音标	悦
电脑配置干嘛的	电脑配置
机械键盘有什么有优点	机械键盘
一般在线翻译大家都用什么	在线翻译
给我推荐几个比较亲民的在线翻译工具	比较
给我用拼音拼一下1	拼
孙悟空是个什么来历	孙悟空
ce认证的意思	ce认证
丁墨到底是什么地方的	丁墨
hadoop	hadoop
ip地址都有什么类型	ip地址
谁写的火影忍者剧场版	火影忍者剧场版
不为谁而作的歌是什么类型的音乐	为谁
秋田犬是哪来的	秋田犬
岳云鹏的搭档是哪位	岳云鹏
每年啥时候过圣诞	诞
虚拟现实有哪些简称	虚拟现实
世界博览会的门票多少钱么	世界博览会
芒果汁有着怎样的做法	芒果汁
刘娜萍歌曲代表作有哪首	刘娜萍
武汉的地理坐标么	武汉
蔡国庆工作的地方	蔡国庆
北京故宫占地面积是多少	北京故宫
宁夏高等院校有哪些	高等院校
hash是什么	hash
可见光的时速	可见光
天宫一号的长度	天宫一号
孙悟空什么人	孙悟空
新三板最初在什么时候	新三板
宋江亲弟名字	宋江
牙套的好处有哪些	牙套
双鱼座的特性是什么	双鱼座
想要见到詹天佑需要回到什么时候	詹天佑
ppap在中国用的什么名称	ppap
你看你看月亮的脸的发行公司是什么	是什么
漩涡慕留人的亲妹妹叫什么名字	漩涡慕留人
冬至处在什么季	冬至
如果接触到voc会出现哪些状况	voc
神奇动物在哪里的作者	神奇动物
那个地方最先提出五位一体的概念	五位一体
tellmewhy的专辑类别是什么	tellmewhy
台湾电影金马奖创办于哪年	台湾电影金马奖
河北华夏幸福足球俱乐部属于什么联赛	河北华夏幸福足球俱乐部
哪里的迪士尼是核心	迪士尼
江户川柯南是谁演的	江户川柯南
中南海在哪	中南海
中南海的地理方位	中南海
诸葛亮是死于什么时候	诸葛亮
flytothesky的艺术风格是哪种	flytothesky
岳云鹏的搭档都有谁	岳云鹏
疯狂动物城的imdb编码信息	动物城
月球的动点到焦点距离和动点到准线的距离之比	月球的动点到焦点距离和动点到准线
volte的含义	volte
秋葵是什么样的物种	秋葵
何时创立的nba	nba
同位语具体要怎么使用	同位语
汉江流域面积多大	汉江
matlab是由什么简化	matlab
会计属于什么系的	会计
蓝胭脂她爹是谁	胭脂
av女忧代表人物都有谁	av
赵雅淇身材比例是多少	赵雅淇
绝世唐门的标签是什么	绝世唐门
一人我饮酒醉有多长	一人
墨西哥的国土面积	墨西哥
一加手机的大小	一加手机
蒙面唱将猜猜猜这个节目是哪个国家的	猜猜猜
ac米兰足球俱乐部经常唱的队歌是啥	ac米兰足球俱乐部
四个全面是谁的指导方针	四个全面
宋江有个亲兄弟是谁	宋江
冰菓由谁策划的	冰菓
黄河的距离是	黄河
宇宙直径你懂不	宇宙
贝拉克·奥巴马他老婆叫啥	贝拉克·奥巴马
中南海位于北京哪里	中南海
谁生的林志颖	林志颖
c语言原来是什么	c
g20峰会的创立时间	g20峰会
微软的代表性产品有什么	微软
检察官跟哪儿上班	检察官
大家管唐纳德·特朗普叫什么	唐纳德·特朗普
十二星座有哪些象征	十二星座
侠盗猎车手5的所属系列	侠盗猎车手5
cvt的工作内容	cvt
58同城的官方品牌定位是哪句话	58同城
关于秘鲁的时区用的是哪个	秘鲁
maven的根本属性	maven
那种尤克里里的材质手感最好	克里
ppp的分类	ppp
天安门的始建时间	天安门
个人简历包涵什么	个人简历
长白山脉最关键的那个山峰	长白山脉
r语言的用途	r语言
温度要控制在多少维生素c才会开始熔化	控制
新加坡英语怎么拼	新加坡英语
开设了会计专业的那个叫什么院系	会计专业
演员外语是啥	演员
在哪个国家流传着陈氏太极拳	陈氏太极拳
谁投资和制作的微微一笑很倾城	微微一笑很倾城
什么公司出的vivo	vivo
bootstrap是什么类型	bootstrap
秋葵的种类	秋葵
啥时候有的草榴社区	草榴社区
改革开放的意义	改革开放
去哪看哆啦a梦的连载	哆啦a梦
杜鹃专长有哪些	杜鹃
超少年密码的播出状态	少年
狼人杀是什么游戏	狼人杀
赵雅淇的三围	赵雅淇
王牌逗王牌的对白语言是什么	王牌
cfr应用在哪个领域	cfr
玻璃由哪些物质构成	玻璃
美人鱼专业名字	美人鱼
哪个台播我们的少年时代	少年时代
论文格式包括什么	论文格式
南京地铁3号线是什么时候首次面向我们的	南京地铁3号线
唐纳德·特朗普被大家都叫做什么	唐纳德·特朗普
kvm为什么好用	kvm
生死狙击的玩家可以有多少	生死狙击
熔炉的来源	熔炉
pmo职能是什么	pmo
youtube的员工数量	youtube
上海虹桥国际机场的建筑面积有多大	上海虹桥国际机场
哪个国家是电影的发源地	电影
007的喜好是什么	007
复旦大学的位置	复旦大学
希尔薇的年龄	希尔
杀生丸喜欢谁	杀生丸
spring的一般运用范围是什么	spring
巴洛克什么时候流行起来的	巴洛克
58同城自己给自己的品牌定位是什么	58同城
提起庄子大家会想到他的哪些作品	庄子
不锈钢的材料	不锈钢
贝拉克·奥巴马妻子叫啥	贝拉克·奥巴马
ipv6名字全拼出来怎么拼	ipv6
介绍几个合肥的大学	合肥
中东主要信什么教	中东
拾穗者去世的时候是哪年	拾穗者
奚梦瑶是一个有着怎样喜好的人	奚梦瑶
ba钡元素的原子量标准数值	ba
谁拥有富士康	富士康
西游记是什么文学体裁	西游记
甘雅丹的歌曲曲风是什么	甘雅丹
拉希奥所在的位置	拉希奥
德国国歌	德国国歌
i的起源	i
迪拜有多大面积	迪拜
是谁画的神印王座	神印王座
苏	苏
苏小妹父亲	苏小妹
长征五号系列运载火箭制造于	长征五号系列运载火箭
问号的语法是什么	问号
什么叫改革开放	改革开放
九州·天空城是哪些人主演的	天空城
何时是诸葛亮逝去的日子	诸葛亮
扮演江户川柯南的人名	江户川柯南
tfboys的出生地	tfboys
电影是从哪里兴起的	电影
哪里有质子重离子治疗技术	重离子
pmc的作用吧	pmc
商标注册的原因	商标注册
华东师范大学在哪儿	华东师范大学
pmc的职能范围	pmc
七鳃鳗是什么食性的动物	七鳃鳗
问号怎样用	问号
雪鹰领主里最重要的是谁	领主
1989这部专辑全程播放的时间是多少	1989
上古卷轴5的创作者是谁	上古卷轴5
是把什么简化成了matlab	matlab
尤克里里的材质是什么材质	克里
国歌的歌曲风格是什么	国歌
加拿大人一般使用什么语言交流	加拿大人
尤克里里都是什么材质制成的	克里
新陈代谢的解释	新陈代谢
谁为jira出资的	jira
诗经别的名字是	诗经
血液透析这种方法可以医治哪种疾病	血液透析
喝可乐会有什么副作用	可乐
长征一共几年	长征
长征五号系列运载火箭现存于	长征五号系列运载火箭
可乐的危害	可乐
小米的价格不	小米
谁是关之琳好友	关之琳
马来西亚的著名城市有哪些	马来西亚
话说瑞士的政治制度是什么体制	话说
maven的本质	maven
猫咪老师的形象是从哪变化来的	猫咪老师
艾滋病的英语吧	艾滋病
钟丽缇会几种语言	钟丽缇
apple'tv能用多少钱买到	apple
王嘉尔的亲人有谁	王嘉尔
走向共和的发行地区	走向共和
湿度是在哪个地方学的	湿度
苏秦是谁的学生	苏秦
李菁的学生都有谁	李菁
边境牧羊犬的性格	边境牧羊犬
做些什么才能职称评审	做些什么
釜山行的韩文	釜山行
管理陈奕迅的是谁	陈奕迅
谁是史蒂夫·乔布斯的妈妈	史蒂夫·乔布斯
关于游戏人生的画面评价	游戏人生
site是啥意思	ite
ppp的分类	ppp
生死狙击有哪些内容是比较重要的	生死狙击
游戏人生拥有什么样的画面	游戏人生
林丹是什么运动员	林丹
长征五号系列运载火箭被哪研发出来的	长征五号系列运载火箭
法国的现任总统是谁	法国
黄河长度是怎样的	黄河
是谁提出的四个全面	四个全面
出品了微微一笑很倾城的是哪个公司	微微一笑很倾城
有哪些可以治疗乳腺结节的方法	乳腺结节
163邮箱有哪些用途	163邮箱
新三板什么时候开始的	新三板
未央宫的建筑面积有多少	未央宫
追梦赤子心拿的那个是什么奖	追梦赤子心
金茂大厦的高度是多少米	金茂大厦
他是龙的画面颜色是什么	是什么
我要你谁唱的	我要你
pmo职能	pmo
泰勒·斯威夫特在何时正式与人们见面的	泰勒·斯威夫特
无花果的门类划分	无花果
acfun的营销口号	acfun
纽约的邮编不	纽约
jira的出资方是谁	jira
在何时创建了人民日报的	人民日报
中国历史朝代的政治体制是什么	中国历史朝代
谁是奔跑吧兄弟的录音	奔跑吧兄弟
谁是黄家驹的弟弟	黄家驹
辐射避难所的游戏下载地址	避难所
r语言都用来干	r
银翼杀手的混音都有谁	银翼杀手
麻省理工学院培养出来哪些很知名的人	麻省理工学院
聚乙烯的沸点是多少度	聚乙烯
后来的我们的mv导演是谁	后来的我们
电磁波有什么坏处	电磁波
中东的宗教信仰	中东
重庆属于哪个区域	重庆
江户川柯南的扮演者叫什么	江户川柯南
薛之谦毕业的地方	薛之谦
美元发行于	美元
加利福尼亚州推荐去哪儿好玩儿	加利福尼亚州
苹果的首席执行官	苹果
什么是电脑配置	电脑配置
拉斯维加斯出现的时间	拉斯维加斯
大肠杆菌的种属不	大肠杆菌
美国队长3制造成本是多少	美国队长3
荷塘月色的创作年代是什么时候	荷塘月色
郑州有哪些著名的人物	郑州
丁墨在什么地方	丁墨
亮剑的颜色	亮剑
华为技术有限公司最初成立是哪一年	华为技术有限公司
运动鞋可以为我们带来什么益处	运动鞋
正态分布谁发现的	正态分布
x射线的特点	x射线
ac米兰足球俱乐部一般唱什么队歌	ac米兰足球俱乐部
兔子一般吃什么	兔子
王俊凯特长	王俊凯
七海千秋对什么感兴趣么	七海千秋
把十二道锋味第二季制作出来的是谁	十二道锋味
bilibili的创始者	bilibili
谁是神奇女侠的老爹	神奇女侠
去南京该玩儿什么地方	南京
什么样的派别会梳公主头	公主头
bobbytinsley的音乐流派是什么	bobbytinsley
床头柜的拼音读法是什么	床头柜
python的发行时间	python
陪你度过漫长岁月的歌曲语言	漫长
辛亥革命的主要人物都有谁	辛亥革命
陶瓷的材料有什么成分	陶瓷
为什么说舒淇性格好	舒淇
那些花儿的其他歌手版本	那些花儿
seo最早出现在多会儿	seo
贝拉克·奥巴马的老婆	贝拉克·奥巴马
歌诗达邮轮啥风格	歌诗达邮轮
红军长征历时多久	红军长征
职称评审的方法	职称评审
小别离制片人信息	小别离
谁唱的she	she
去秘鲁的话需要切换到哪种时区	秘鲁
慈禧把陵墓建在了哪里	慈禧
什么温度是铝合金能承受的底线	铝合金
悦字怎么读	悦
亚洲有什么其他的意译	亚洲
捉鬼记别名叫什么	捉鬼记
完美世界是在哪儿出版的	完美世界
巴厘岛有哪些通用语言	巴厘岛
乌冬面的烹饪方法	乌冬面
邓紫棋喜欢的食物	邓紫棋
新加坡英文说法	新加坡
洛杉矶的火车站都叫什么名字	洛杉矶
南京地铁3号线第一班车是哪天发的	南京地铁3号线
杨洋身高	杨洋
王家卫都有哪些亲属	王家卫
iphone6s品牌	iphone6s
陪你度过漫长岁月是哪种语言	漫长
自传	自传
托福有什么样的	托福
马思纯所在哪个民族	马思纯
谁帮杨幂进行宣传的	杨幂
谁是文殊菩萨的坐骑	文殊菩萨
哪里被定为发射神舟十一号飞船的地方	神舟十一号飞船
扮演猪八戒的人有哪些	猪八戒
.xxx指什么	.xxx
劳尔·卡斯特罗的兄长是谁	劳尔·卡斯特罗
用外语说演员	外语
后来的原曲是哪首	后来
三体的另一个名字是什么	三体
杨绛的女儿是哪位	杨绛
绝世唐门是什么类的书	绝世唐门
3d打印是哪位做出来的	3d打印
魅族的员工人数	魅族
vhd在哪里出现的	vhd
intelskylake叫什么	intelskylake
是谁一手操控完成了上古卷轴5的	上古卷轴5
谁是富士康的老板	富士康
荷兰国家的代码	荷兰
ba的原子量是多少	ba
我的奇妙男友是谁编的	男友
张国荣最喜欢做的事情	张国荣
巴黎圣母院那么长到底用了多久	巴黎圣母院
哪些名人彼此是麻省理工学院的校友	麻省理工学院
全民超神在哪个网站下载	超神
fyi是啥	fyi
余罪每集时长是多少	余罪
介绍几个长沙的大学给我	长沙
匈牙利的中央银行叫什么	匈牙利
长征起止日期	长征
蜂蜜有什么营养价值	蜂蜜
伊丽莎白的作曲者是谁	伊丽莎白
杭州占地多少	杭州
windowspowershell的平台叫什么	windowspowershell
和新闻相近的词语有什么	新闻
盂兰盆节内有哪些活动	盂兰盆节
金瓶梅由谁发行的	金瓶梅
谁喊唐僧叫师傅	唐僧
maven的本质	maven
董力归哪个队	董力
艾吉奥的后裔都是谁	艾吉奥
马赛曲的其他版本叫什么	马赛曲
世界博览会的票价	世界博览会
宋仲基粉丝叫什么	宋仲基
新qq的运行时间	qq
王嘉尔的家属	王嘉尔
元旦的设定时间	元旦
瑜伽日在几月几号过	瑜伽
nas网络存储是什么属性	nas网络存储
奇妙能力歌的作词者	奇妙能力歌
spring可以在哪里进行应用运行	spring
hao123的总公司全称是	hao123
碰到voc会让人出现什么样的问题	人
大家都管田馥甄的粉丝叫什么	田馥甄
出现哪些症状代表可能会得抑郁症了	出现哪些症状代表可能会得抑郁症了
艾吉奥都是谁的先辈	艾吉奥
flytothesky的曲风	flytothesky
怎样计算市净率	市净率
58同城的品牌定位	58同城
王思聪的爸爸是谁	王思聪
小米多少钱么	小米
锦绣未央的小说是哪本	锦绣未央
怎么叫第一次世界大战比较好	第一次世界大战
哪位是扎马斯的老师	马斯
说几个长沙的大学	长沙
松花江的流域面积	松花江
缅甸有多少面积	缅甸
安徽最好玩儿的是哪儿	安徽
kenarai经典老歌是什么	kenarai
请叫我英雄的翻译作者是谁	请叫我英雄
市净率最简单的计算方法是什么	市净率
王健林的母亲是哪位	王健林
印度的人数	印度
未央宫有多大	未央宫
163的形式	163
燕麦毒性	燕麦
比亚迪股份有限公司涵盖多大的面积	比亚迪股份有限公司
切·格瓦拉娶了谁	切·格瓦拉
张起灵的爷爷	张起灵
尿毒症是什么	尿毒症
site咋解释	ite
做饥荒的叫什么名字	饥荒
酷儿多高多重	酷儿
ds能耗多少油	ds
qq邮箱外文名是什么	qq邮箱
iphone7啥系统	iphone7
龚琳娜的丈夫	龚琳娜
洛杉矶火车站是什么	洛杉矶
澳门总共有多少人	澳门
一帘幽梦有哪些歌手翻唱过	一帘幽梦
赵一荻是谁的夫人	赵一荻
1024是什么节日	1024
洛阳有没有著名的高等院校?具体有哪些	有没有
喜欢李易峰的都叫什么	李易峰
拉希奥的位置在哪儿	拉希奥
地球的质量	地球
pdca循环	pdca循环
谁发明的3d打印	3d
qq邮箱用英语怎么说	qq邮箱
树莓派的简称是什么	树莓派
圆梦巨人是什么等级的电影	圆梦巨人
日本首都是什么	日本首都
qq空间最新版是多少	qq空间
谁把骁龙820做出来的	骁龙820
过端午节可以吃什么	端午节
蓝胭脂亲爹叫什么名字	胭脂
贵金属可以做成什么	贵金属
维密天使最火的是谁	维密天使
163邮箱是干啥的	163邮箱
完美世界的出版社	完美世界
徐志摩之前的老婆	徐志摩
谁是蒋雯丽的爱人	蒋雯丽
百度百科母公司是哪家	百度百科
冰点脱毛的方法	冰点脱毛
dns劫持的影响是什么	dns劫持
行尸走肉的作画作者	行尸走肉
晋祠圣母殿侍女像到最上面有多高	晋祠圣母殿侍女像
osi参考模型是何时设定的	osi参考模型
mindgeek的研发团队	geek
什么形式里有163	163
锦绣未央书名	锦绣未央
谁做的iphone6s	iphone6s
谁是冰菓摄制资金的策划人	摄制
秋田犬是哪个国家的狗	秋田犬
青云志的制作国家是哪个	青云志
黄山是什么级别的旅游景点	黄山
iphone7用的是啥系统	iphone7
生死狙击的玩家人数	生死狙击
c语言是由什么演变出来的	c语言
sat还有什么说法	sat
中秋节的流传地区在哪里	中秋节
一般养殖葡萄海拔要控制在多少范围内	葡萄
你看你看月亮的脸的发行公司叫什么	叫什么
龙眼属于哪个目	龙眼
乔任梁是什么星座的	乔任梁
龙眼是哪个目的么	龙眼
投名状花费	投名状
瑜伽节具体的时间	瑜伽
葛雷·奥特曼谁唱的	葛雷·奥特曼
哪年出版的白鹿原	白鹿原
丢番图活到了哪年	丢番图
穿越火线都有什么主角	穿越火线
老九门还有别的翻译方式	老九门
svchost.exe的服务商是什么	svchost.exe
hdmi有啥特质	hdmi
贝加尔湖的平均深度	贝加尔湖
马云的主要成就有哪些	马云
泰勒·斯威夫特什么时候初次亮相的	泰勒·斯威夫特
唐三女儿的丈夫	女儿
马云的经历都有什么	马云
怎样做乌冬面好吃	乌冬面
香港的电话区号么	香港
高铁每小时能跑多少	小时
帮王力宏进行音乐推广的是哪家公司	王力宏
春节的节日活动	春节
五四运动造成了什么后果	五四运动
唱t的是谁	是谁
匈牙利的中央银行	匈牙利
秘鲁的标准时区是什么	秘鲁
釜山行用韩语怎么说	釜山行
张国荣的爱好有哪些	张国荣
木村拓哉是怎样的人	木村拓哉
微软的代表性产品	微软
在哪儿可以看到蒙面唱将猜猜猜的录制现场	猜猜猜
谁是猪八戒的饰演者	猪八戒
伊利诺伊大学厄巴纳-香槟分校的性质是什么	伊利诺伊大学厄巴纳-香槟分校
centos资费标准	centos
纸牌屋的imdb编号是什么	纸牌屋
三里屯开放时间是什么	三里屯
黄山的景点级别	黄山
中国新歌声谁主持的	新歌
蓝胭脂的亲爹	胭脂
lisp的源头	lisp
什么解释可以阐述表情符号	表情符号
画江湖之不良人的音乐制作是谁	画江湖之不良人
社会保险最终的目的是什么	社会保险
能不能说下什么是欧洲的原始意义	能
谁是艾吉奥的后裔	艾吉奥
扎马斯的老师是哪位	马斯
呼斯楞的演唱特点	呼斯楞
萌萌哒天团在哪里创办	萌萌哒天团
